barcode	position
GAAGGGTGTGGGGTGCGGGCCCGTTACCCCCTTCCGGAGCTAAGTGGGAGCCTCTTAACCAGGCGCACGTCGCACGCACCGGGCCGATGCGCGTCTGGCGTCCCCCTGCCGCAGCGCCCC	Cassette1_1
TAAGGGTGTGGGGTGCGGGCCCGTTACCCCCTTCCGGAGCTAAGTGGGAGCCTCTTAACCAGGCGCACGTCGCACGCACCGGGCCGATGCGCGTCTGGCGTCCCCCTGCCGCAGCGCCCC	Cassette1_1
AGGCGGTGTGGGGTGCGGGCCCGTTACCCCCTTCCGGAGCTAAGTGGGAGCCTCTTAACCAGGCGCACGTCGCACGCACCGGGCCGATGCGCGTCTGGCGTCCCCCTGCCGCAGCGCCCC	Cassette1_2
ATGCGGTGTGGGGTGCGGGCCCGTTACCCCCTTCCGGAGCTAAGTGGGAGCCTCTTAACCAGGCGCACGTCGCACGCACCGGGCCGATGCGCGTCTGGCGTCCCCCTGCCGCAGCGCCCC	Cassette1_2
AGGGAGTGTGGGGTGCGGGCCCGTTACCCCCTTCCGGAGCTAAGTGGGAGCCTCTTAACCAGGCGCACGTCGCACGCACCGGGCCGATGCGCGTCTGGCGTCCCCCTGCCGCAGCGCCCC	Cassette1_3
AGTGAGTGTGGGGTGCGGGCCCGTTACCCCCTTCCGGAGCTAAGTGGGAGCCTCTTAACCAGGCGCACGTCGCACGCACCGGGCCGATGCGCGTCTGGCGTCCCCCTGCCGCAGCGCCCC	Cassette1_3
GAGGAGTGTGGGGTGCGGGCCCGTTACCCCCTTCCGGAGCTAAGTGGGAGCCTCTTAACCAGGCGCACGTCGCACGCACCGGGCCGATGCGCGTCTGGCGTCCCCCTGCCGCAGCGCCCC	Cassette1_4
GAGTAGTGTGGGGTGCGGGCCCGTTACCCCCTTCCGGAGCTAAGTGGGAGCCTCTTAACCAGGCGCACGTCGCACGCACCGGGCCGATGCGCGTCTGGCGTCCCCCTGCCGCAGCGCCCC	Cassette1_4
GGACGGTGTGGGGTGCGGGCCCGTTACCCCCTTCCGGAGCTAAGTGGGAGCCTCTTAACCAGGCGCACGTCGCACGCACCGGGCCGATGCGCGTCTGGCGTCCCCCTGCCGCAGCGCCCC	Cassette1_5
GGACTGTGTGGGGTGCGGGCCCGTTACCCCCTTCCGGAGCTAAGTGGGAGCCTCTTAACCAGGCGCACGTCGCACGCACCGGGCCGATGCGCGTCTGGCGTCCCCCTGCCGCAGCGCCCC	Cassette1_5
AAACAGTGTGGGGTGCGGGCCCGTTACCCCCTTCCGGAGCTAAGTGGGAGCCTCTTAACCAGGCGCACGTCGCACGCACCGGGCCGATGCGCGTCTGGCGTCCCCCTGCCGCAGCGCCCC	Cassette1_6
AAACATTGTGGGGTGCGGGCCCGTTACCCCCTTCCGGAGCTAAGTGGGAGCCTCTTAACCAGGCGCACGTCGCACGCACCGGGCCGATGCGCGTCTGGCGTCCCCCTGCCGCAGCGCCCC	Cassette1_6
AAGGAAGGTGGGGTGCGGGCCCGTTACCCCCTTCCGGAGCTAAGTGGGAGCCTCTTAACCAGGCGCACGTCGCACGCACCGGGCCGATGCGCGTCTGGCGTCCCCCTGCCGCAGCGCCCC	Cassette1_7
AAGGAATGTGGGGTGCGGGCCCGTTACCCCCTTCCGGAGCTAAGTGGGAGCCTCTTAACCAGGCGCACGTCGCACGCACCGGGCCGATGCGCGTCTGGCGTCCCCCTGCCGCAGCGCCCC	Cassette1_7
AGACGATGTGGGGTGCGGGCCCGTTACCCCCTTCCGGAGCTAAGTGGGAGCCTCTTAACCAGGCGCACGTCGCACGCACCGGGCCGATGCGCGTCTGGCGTCCCCCTGCCGCAGCGCCCC	Cassette1_8
AGACGATTTGGGGTGCGGGCCCGTTACCCCCTTCCGGAGCTAAGTGGGAGCCTCTTAACCAGGCGCACGTCGCACGCACCGGGCCGATGCGCGTCTGGCGTCCCCCTGCCGCAGCGCCCC	Cassette1_8
GGGGGGTGGAAGGTGCGGGCCCGTTACCCCCTTCCGGAGCTAAGTGGGAGCCTCTTAACCAGGCGCACGTCGCACGCACCGGGCCGATGCGCGTCTGGCGTCCCCCTGCCGCAGCGCCCC	Cassette2_1
GGGGGGTGTAAGGTGCGGGCCCGTTACCCCCTTCCGGAGCTAAGTGGGAGCCTCTTAACCAGGCGCACGTCGCACGCACCGGGCCGATGCGCGTCTGGCGTCCCCCTGCCGCAGCGCCCC	Cassette2_1
GGGGGGTGAGGAGTGCGGGCCCGTTACCCCCTTCCGGAGCTAAGTGGGAGCCTCTTAACCAGGCGCACGTCGCACGCACCGGGCCGATGCGCGTCTGGCGTCCCCCTGCCGCAGCGCCCC	Cassette2_2
GGGGGGTGATGAGTGCGGGCCCGTTACCCCCTTCCGGAGCTAAGTGGGAGCCTCTTAACCAGGCGCACGTCGCACGCACCGGGCCGATGCGCGTCTGGCGTCCCCCTGCCGCAGCGCCCC	Cassette2_2
GGGGGGTGAGGGATGCGGGCCCGTTACCCCCTTCCGGAGCTAAGTGGGAGCCTCTTAACCAGGCGCACGTCGCACGCACCGGGCCGATGCGCGTCTGGCGTCCCCCTGCCGCAGCGCCCC	Cassette2_3
GGGGGGTGAGTGATGCGGGCCCGTTACCCCCTTCCGGAGCTAAGTGGGAGCCTCTTAACCAGGCGCACGTCGCACGCACCGGGCCGATGCGCGTCTGGCGTCCCCCTGCCGCAGCGCCCC	Cassette2_3
GGGGGGTGTAGGATGCGGGCCCGTTACCCCCTTCCGGAGCTAAGTGGGAGCCTCTTAACCAGGCGCACGTCGCACGCACCGGGCCGATGCGCGTCTGGCGTCCCCCTGCCGCAGCGCCCC	Cassette2_4
GGGGGGTGTAGTATGCGGGCCCGTTACCCCCTTCCGGAGCTAAGTGGGAGCCTCTTAACCAGGCGCACGTCGCACGCACCGGGCCGATGCGCGTCTGGCGTCCCCCTGCCGCAGCGCCCC	Cassette2_4
GGGGGGTGTGAAGTGCGGGCCCGTTACCCCCTTCCGGAGCTAAGTGGGAGCCTCTTAACCAGGCGCACGTCGCACGCACCGGGCCGATGCGCGTCTGGCGTCCCCCTGCCGCAGCGCCCC	Cassette2_5
GGGGGGTGTGAATTGCGGGCCCGTTACCCCCTTCCGGAGCTAAGTGGGAGCCTCTTAACCAGGCGCACGTCGCACGCACCGGGCCGATGCGCGTCTGGCGTCCCCCTGCCGCAGCGCCCC	Cassette2_5
GGGGGGTGAAAAAGGCGGGCCCGTTACCCCCTTCCGGAGCTAAGTGGGAGCCTCTTAACCAGGCGCACGTCGCACGCACCGGGCCGATGCGCGTCTGGCGTCCCCCTGCCGCAGCGCCCC	Cassette2_6
GGGGGGTGAAAAATGCGGGCCCGTTACCCCCTTCCGGAGCTAAGTGGGAGCCTCTTAACCAGGCGCACGTCGCACGCACCGGGCCGATGCGCGTCTGGCGTCCCCCTGCCGCAGCGCCCC	Cassette2_6
GGGGGGTGAGAGGGGCGGGCCCGTTACCCCCTTCCGGAGCTAAGTGGGAGCCTCTTAACCAGGCGCACGTCGCACGCACCGGGCCGATGCGCGTCTGGCGTCCCCCTGCCGCAGCGCCCC	Cassette2_7
GGGGGGTGAGAGGGTCGGGCCCGTTACCCCCTTCCGGAGCTAAGTGGGAGCCTCTTAACCAGGCGCACGTCGCACGCACCGGGCCGATGCGCGTCTGGCGTCCCCCTGCCGCAGCGCCCC	Cassette2_7
GGGGGGTGAGGAAGGGGGGCCCGTTACCCCCTTCCGGAGCTAAGTGGGAGCCTCTTAACCAGGCGCACGTCGCACGCACCGGGCCGATGCGCGTCTGGCGTCCCCCTGCCGCAGCGCCCC	Cassette2_8
GGGGGGTGAGGAAGGTGGGCCCGTTACCCCCTTCCGGAGCTAAGTGGGAGCCTCTTAACCAGGCGCACGTCGCACGCACCGGGCCGATGCGCGTCTGGCGTCCCCCTGCCGCAGCGCCCC	Cassette2_8
GGGGGGTGTGGGGTGCGAACCCGTTACCCCCTTCCGGAGCTAAGTGGGAGCCTCTTAACCAGGCGCACGTCGCACGCACCGGGCCGATGCGCGTCTGGCGTCCCCCTGCCGCAGCGCCCC	Cassette3_1
GGGGGGTGTGGGGTGCTAACCCGTTACCCCCTTCCGGAGCTAAGTGGGAGCCTCTTAACCAGGCGCACGTCGCACGCACCGGGCCGATGCGCGTCTGGCGTCCCCCTGCCGCAGCGCCCC	Cassette3_1
GGGGGGTGTGGGGTGCTGGACCGTTACCCCCTTCCGGAGCTAAGTGGGAGCCTCTTAACCAGGCGCACGTCGCACGCACCGGGCCGATGCGCGTCTGGCGTCCCCCTGCCGCAGCGCCCC	Cassette3_2
GGGGGGTGTGGGGTGCTTGACCGTTACCCCCTTCCGGAGCTAAGTGGGAGCCTCTTAACCAGGCGCACGTCGCACGCACCGGGCCGATGCGCGTCTGGCGTCCCCCTGCCGCAGCGCCCC	Cassette3_2
GGGGGGTGTGGGGTGCTGGCTCGTTACCCCCTTCCGGAGCTAAGTGGGAGCCTCTTAACCAGGCGCACGTCGCACGCACCGGGCCGATGCGCGTCTGGCGTCCCCCTGCCGCAGCGCCCC	Cassette3_3
GGGGGGTGTGGGGTGCTGTCTCGTTACCCCCTTCCGGAGCTAAGTGGGAGCCTCTTAACCAGGCGCACGTCGCACGCACCGGGCCGATGCGCGTCTGGCGTCCCCCTGCCGCAGCGCCCC	Cassette3_3
GGGGGGTGTGGGGTGCGAGGTCGTTACCCCCTTCCGGAGCTAAGTGGGAGCCTCTTAACCAGGCGCACGTCGCACGCACCGGGCCGATGCGCGTCTGGCGTCCCCCTGCCGCAGCGCCCC	Cassette3_4
GGGGGGTGTGGGGTGCGAGTTCGTTACCCCCTTCCGGAGCTAAGTGGGAGCCTCTTAACCAGGCGCACGTCGCACGCACCGGGCCGATGCGCGTCTGGCGTCCCCCTGCCGCAGCGCCCC	Cassette3_4
GGGGGGTGTGGGGTGCGGAAGCGTTACCCCCTTCCGGAGCTAAGTGGGAGCCTCTTAACCAGGCGCACGTCGCACGCACCGGGCCGATGCGCGTCTGGCGTCCCCCTGCCGCAGCGCCCC	Cassette3_5
GGGGGGTGTGGGGTGCGGAATCGTTACCCCCTTCCGGAGCTAAGTGGGAGCCTCTTAACCAGGCGCACGTCGCACGCACCGGGCCGATGCGCGTCTGGCGTCCCCCTGCCGCAGCGCCCC	Cassette3_5
GGGGGGTGTGGGGTGCTAAATGGTTACCCCCTTCCGGAGCTAAGTGGGAGCCTCTTAACCAGGCGCACGTCGCACGCACCGGGCCGATGCGCGTCTGGCGTCCCCCTGCCGCAGCGCCCC	Cassette3_6
GGGGGGTGTGGGGTGCTAAATTGTTACCCCCTTCCGGAGCTAAGTGGGAGCCTCTTAACCAGGCGCACGTCGCACGCACCGGGCCGATGCGCGTCTGGCGTCCCCCTGCCGCAGCGCCCC	Cassette3_6
GGGGGGTGTGGGGTGCTAGCTTGTTACCCCCTTCCGGAGCTAAGTGGGAGCCTCTTAACCAGGCGCACGTCGCACGCACCGGGCCGATGCGCGTCTGGCGTCCCCCTGCCGCAGCGCCCC	Cassette3_7
GGGGGGTGTGGGGTGCTAGCTTTTTACCCCCTTCCGGAGCTAAGTGGGAGCCTCTTAACCAGGCGCACGTCGCACGCACCGGGCCGATGCGCGTCTGGCGTCCCCCTGCCGCAGCGCCCC	Cassette3_7
GGGGGGTGTGGGGTGCTGGATTGGTACCCCCTTCCGGAGCTAAGTGGGAGCCTCTTAACCAGGCGCACGTCGCACGCACCGGGCCGATGCGCGTCTGGCGTCCCCCTGCCGCAGCGCCCC	Cassette3_8
GGGGGGTGTGGGGTGCTGGATTGTTACCCCCTTCCGGAGCTAAGTGGGAGCCTCTTAACCAGGCGCACGTCGCACGCACCGGGCCGATGCGCGTCTGGCGTCCCCCTGCCGCAGCGCCCC	Cassette3_8
GGGGGGTGTGGGGTGCGGGCCCGTGTTCCCCTTCCGGAGCTAAGTGGGAGCCTCTTAACCAGGCGCACGTCGCACGCACCGGGCCGATGCGCGTCTGGCGTCCCCCTGCCGCAGCGCCCC	Cassette4_1
GGGGGGTGTGGGGTGCGGGCCCGTTTTCCCCTTCCGGAGCTAAGTGGGAGCCTCTTAACCAGGCGCACGTCGCACGCACCGGGCCGATGCGCGTCTGGCGTCCCCCTGCCGCAGCGCCCC	Cassette4_1
GGGGGGTGTGGGGTGCGGGCCCGTGGCACCCTTCCGGAGCTAAGTGGGAGCCTCTTAACCAGGCGCACGTCGCACGCACCGGGCCGATGCGCGTCTGGCGTCCCCCTGCCGCAGCGCCCC	Cassette4_2
GGGGGGTGTGGGGTGCGGGCCCGTGTCACCCTTCCGGAGCTAAGTGGGAGCCTCTTAACCAGGCGCACGTCGCACGCACCGGGCCGATGCGCGTCTGGCGTCCCCCTGCCGCAGCGCCCC	Cassette4_2
GGGGGGTGTGGGGTGCGGGCCCGTTTGATCCTTCCGGAGCTAAGTGGGAGCCTCTTAACCAGGCGCACGTCGCACGCACCGGGCCGATGCGCGTCTGGCGTCCCCCTGCCGCAGCGCCCC	Cassette4_3
GGGGGGTGTGGGGTGCGGGCCCGTTTTATCCTTCCGGAGCTAAGTGGGAGCCTCTTAACCAGGCGCACGTCGCACGCACCGGGCCGATGCGCGTCTGGCGTCCCCCTGCCGCAGCGCCCC	Cassette4_3
GGGGGGTGTGGGGTGCGGGCCCGTGATGTCCTTCCGGAGCTAAGTGGGAGCCTCTTAACCAGGCGCACGTCGCACGCACCGGGCCGATGCGCGTCTGGCGTCCCCCTGCCGCAGCGCCCC	Cassette4_4
GGGGGGTGTGGGGTGCGGGCCCGTGATTTCCTTCCGGAGCTAAGTGGGAGCCTCTTAACCAGGCGCACGTCGCACGCACCGGGCCGATGCGCGTCTGGCGTCCCCCTGCCGCAGCGCCCC	Cassette4_4
GGGGGGTGTGGGGTGCGGGCCCGTTTCCGTCTTCCGGAGCTAAGTGGGAGCCTCTTAACCAGGCGCACGTCGCACGCACCGGGCCGATGCGCGTCTGGCGTCCCCCTGCCGCAGCGCCCC	Cassette4_5
GGGGGGTGTGGGGTGCGGGCCCGTTTCCTTCTTCCGGAGCTAAGTGGGAGCCTCTTAACCAGGCGCACGTCGCACGCACCGGGCCGATGCGCGTCTGGCGTCCCCCTGCCGCAGCGCCCC	Cassette4_5
GGGGGGTGTGGGGTGCGGGCCCGTTATACGCTTCCGGAGCTAAGTGGGAGCCTCTTAACCAGGCGCACGTCGCACGCACCGGGCCGATGCGCGTCTGGCGTCCCCCTGCCGCAGCGCCCC	Cassette4_6
GGGGGGTGTGGGGTGCGGGCCCGTTATACTCTTCCGGAGCTAAGTGGGAGCCTCTTAACCAGGCGCACGTCGCACGCACCGGGCCGATGCGCGTCTGGCGTCCCCCTGCCGCAGCGCCCC	Cassette4_6
GGGGGGTGTGGGGTGCGGGCCCGTGTCCTCGTTCCGGAGCTAAGTGGGAGCCTCTTAACCAGGCGCACGTCGCACGCACCGGGCCGATGCGCGTCTGGCGTCCCCCTGCCGCAGCGCCCC	Cassette4_7
GGGGGGTGTGGGGTGCGGGCCCGTGTCCTCTTTCCGGAGCTAAGTGGGAGCCTCTTAACCAGGCGCACGTCGCACGCACCGGGCCGATGCGCGTCTGGCGTCCCCCTGCCGCAGCGCCCC	Cassette4_7
GGGGGGTGTGGGGTGCGGGCCCGTTATCTTCGTCCGGAGCTAAGTGGGAGCCTCTTAACCAGGCGCACGTCGCACGCACCGGGCCGATGCGCGTCTGGCGTCCCCCTGCCGCAGCGCCCC	Cassette4_8
GGGGGGTGTGGGGTGCGGGCCCGTTATCTTCTTCCGGAGCTAAGTGGGAGCCTCTTAACCAGGCGCACGTCGCACGCACCGGGCCGATGCGCGTCTGGCGTCCCCCTGCCGCAGCGCCCC	Cassette4_8
GGGGGGTGTGGGGTGCGGGCCCGTTACCCCCTGATGGAGCTAAGTGGGAGCCTCTTAACCAGGCGCACGTCGCACGCACCGGGCCGATGCGCGTCTGGCGTCCCCCTGCCGCAGCGCCCC	Cassette5_1
GGGGGGTGTGGGGTGCGGGCCCGTTACCCCCTTATGGAGCTAAGTGGGAGCCTCTTAACCAGGCGCACGTCGCACGCACCGGGCCGATGCGCGTCTGGCGTCCCCCTGCCGCAGCGCCCC	Cassette5_1
GGGGGGTGTGGGGTGCGGGCCCGTTACCCCCTAGCGAAGCTAAGTGGGAGCCTCTTAACCAGGCGCACGTCGCACGCACCGGGCCGATGCGCGTCTGGCGTCCCCCTGCCGCAGCGCCCC	Cassette5_2
GGGGGGTGTGGGGTGCGGGCCCGTTACCCCCTATCGAAGCTAAGTGGGAGCCTCTTAACCAGGCGCACGTCGCACGCACCGGGCCGATGCGCGTCTGGCGTCCCCCTGCCGCAGCGCCCC	Cassette5_2
GGGGGGTGTGGGGTGCGGGCCCGTTACCCCCTACGGGCGCTAAGTGGGAGCCTCTTAACCAGGCGCACGTCGCACGCACCGGGCCGATGCGCGTCTGGCGTCCCCCTGCCGCAGCGCCCC	Cassette5_3
GGGGGGTGTGGGGTGCGGGCCCGTTACCCCCTACTGGCGCTAAGTGGGAGCCTCTTAACCAGGCGCACGTCGCACGCACCGGGCCGATGCGCGTCTGGCGTCCCCCTGCCGCAGCGCCCC	Cassette5_3
GGGGGGTGTGGGGTGCGGGCCCGTTACCCCCTTCTGAAGCTAAGTGGGAGCCTCTTAACCAGGCGCACGTCGCACGCACCGGGCCGATGCGCGTCTGGCGTCCCCCTGCCGCAGCGCCCC	Cassette5_4
GGGGGGTGTGGGGTGCGGGCCCGTTACCCCCTTCTTAAGCTAAGTGGGAGCCTCTTAACCAGGCGCACGTCGCACGCACCGGGCCGATGCGCGTCTGGCGTCCCCCTGCCGCAGCGCCCC	Cassette5_4
GGGGGGTGTGGGGTGCGGGCCCGTTACCCCCTTACGGCGCTAAGTGGGAGCCTCTTAACCAGGCGCACGTCGCACGCACCGGGCCGATGCGCGTCTGGCGTCCCCCTGCCGCAGCGCCCC	Cassette5_5
GGGGGGTGTGGGGTGCGGGCCCGTTACCCCCTTACGTCGCTAAGTGGGAGCCTCTTAACCAGGCGCACGTCGCACGCACCGGGCCGATGCGCGTCTGGCGTCCCCCTGCCGCAGCGCCCC	Cassette5_5
GGGGGGTGTGGGGTGCGGGCCCGTTACCCCCTACTGAGACTAAGTGGGAGCCTCTTAACCAGGCGCACGTCGCACGCACCGGGCCGATGCGCGTCTGGCGTCCCCCTGCCGCAGCGCCCC	Cassette5_6
GGGGGGTGTGGGGTGCGGGCCCGTTACCCCCTACTGATACTAAGTGGGAGCCTCTTAACCAGGCGCACGTCGCACGCACCGGGCCGATGCGCGTCTGGCGTCCCCCTGCCGCAGCGCCCC	Cassette5_6
GGGGGGTGTGGGGTGCGGGCCCGTTACCCCCTACCGACGATAAGTGGGAGCCTCTTAACCAGGCGCACGTCGCACGCACCGGGCCGATGCGCGTCTGGCGTCCCCCTGCCGCAGCGCCCC	Cassette5_7
GGGGGGTGTGGGGTGCGGGCCCGTTACCCCCTACCGACTATAAGTGGGAGCCTCTTAACCAGGCGCACGTCGCACGCACCGGGCCGATGCGCGTCTGGCGTCCCCCTGCCGCAGCGCCCC	Cassette5_7
GGGGGGTGTGGGGTGCGGGCCCGTTACCCCCTAATGACGGTAAGTGGGAGCCTCTTAACCAGGCGCACGTCGCACGCACCGGGCCGATGCGCGTCTGGCGTCCCCCTGCCGCAGCGCCCC	Cassette5_8
GGGGGGTGTGGGGTGCGGGCCCGTTACCCCCTAATGACGTTAAGTGGGAGCCTCTTAACCAGGCGCACGTCGCACGCACCGGGCCGATGCGCGTCTGGCGTCCCCCTGCCGCAGCGCCCC	Cassette5_8
GGGGGGTGTGGGGTGCGGGCCCGTTACCCCCTTCCGGAGCGTGGTGGGAGCCTCTTAACCAGGCGCACGTCGCACGCACCGGGCCGATGCGCGTCTGGCGTCCCCCTGCCGCAGCGCCCC	Cassette6_1
GGGGGGTGTGGGGTGCGGGCCCGTTACCCCCTTCCGGAGCTTGGTGGGAGCCTCTTAACCAGGCGCACGTCGCACGCACCGGGCCGATGCGCGTCTGGCGTCCCCCTGCCGCAGCGCCCC	Cassette6_1
GGGGGGTGTGGGGTGCGGGCCCGTTACCCCCTTCCGGAGCGGATTGGGAGCCTCTTAACCAGGCGCACGTCGCACGCACCGGGCCGATGCGCGTCTGGCGTCCCCCTGCCGCAGCGCCCC	Cassette6_2
GGGGGGTGTGGGGTGCGGGCCCGTTACCCCCTTCCGGAGCGTATTGGGAGCCTCTTAACCAGGCGCACGTCGCACGCACCGGGCCGATGCGCGTCTGGCGTCCCCCTGCCGCAGCGCCCC	Cassette6_2
GGGGGGTGTGGGGTGCGGGCCCGTTACCCCCTTCCGGAGCTTGTCGGGAGCCTCTTAACCAGGCGCACGTCGCACGCACCGGGCCGATGCGCGTCTGGCGTCCCCCTGCCGCAGCGCCCC	Cassette6_3
GGGGGGTGTGGGGTGCGGGCCCGTTACCCCCTTCCGGAGCTTTTCGGGAGCCTCTTAACCAGGCGCACGTCGCACGCACCGGGCCGATGCGCGTCTGGCGTCCCCCTGCCGCAGCGCCCC	Cassette6_3
GGGGGGTGTGGGGTGCGGGCCCGTTACCCCCTTCCGGAGCGAGGCGGGAGCCTCTTAACCAGGCGCACGTCGCACGCACCGGGCCGATGCGCGTCTGGCGTCCCCCTGCCGCAGCGCCCC	Cassette6_4
GGGGGGTGTGGGGTGCGGGCCCGTTACCCCCTTCCGGAGCGAGTCGGGAGCCTCTTAACCAGGCGCACGTCGCACGCACCGGGCCGATGCGCGTCTGGCGTCCCCCTGCCGCAGCGCCCC	Cassette6_4
GGGGGGTGTGGGGTGCGGGCCCGTTACCCCCTTCCGGAGCTTAGGAGGAGCCTCTTAACCAGGCGCACGTCGCACGCACCGGGCCGATGCGCGTCTGGCGTCCCCCTGCCGCAGCGCCCC	Cassette6_5
GGGGGGTGTGGGGTGCGGGCCCGTTACCCCCTTCCGGAGCTTAGTAGGAGCCTCTTAACCAGGCGCACGTCGCACGCACCGGGCCGATGCGCGTCTGGCGTCCCCCTGCCGCAGCGCCCC	Cassette6_5
GGGGGGTGTGGGGTGCGGGCCCGTTACCCCCTTCCGGAGCTAGTTGGGAGCCTCTTAACCAGGCGCACGTCGCACGCACCGGGCCGATGCGCGTCTGGCGTCCCCCTGCCGCAGCGCCCC	Cassette6_6
GGGGGGTGTGGGGTGCGGGCCCGTTACCCCCTTCCGGAGCTAGTTTGGAGCCTCTTAACCAGGCGCACGTCGCACGCACCGGGCCGATGCGCGTCTGGCGTCCCCCTGCCGCAGCGCCCC	Cassette6_6
GGGGGGTGTGGGGTGCGGGCCCGTTACCCCCTTCCGGAGCGTAGCGGGAGCCTCTTAACCAGGCGCACGTCGCACGCACCGGGCCGATGCGCGTCTGGCGTCCCCCTGCCGCAGCGCCCC	Cassette6_7
GGGGGGTGTGGGGTGCGGGCCCGTTACCCCCTTCCGGAGCGTAGCGTGAGCCTCTTAACCAGGCGCACGTCGCACGCACCGGGCCGATGCGCGTCTGGCGTCCCCCTGCCGCAGCGCCCC	Cassette6_7
GGGGGGTGTGGGGTGCGGGCCCGTTACCCCCTTCCGGAGCTAATCAGGAGCCTCTTAACCAGGCGCACGTCGCACGCACCGGGCCGATGCGCGTCTGGCGTCCCCCTGCCGCAGCGCCCC	Cassette6_8
GGGGGGTGTGGGGTGCGGGCCCGTTACCCCCTTCCGGAGCTAATCAGTAGCCTCTTAACCAGGCGCACGTCGCACGCACCGGGCCGATGCGCGTCTGGCGTCCCCCTGCCGCAGCGCCCC	Cassette6_8
GGGGGGTGTGGGGTGCGGGCCCGTTACCCCCTTCCGGAGCTAAGTGGGGTACTCTTAACCAGGCGCACGTCGCACGCACCGGGCCGATGCGCGTCTGGCGTCCCCCTGCCGCAGCGCCCC	Cassette7_1
GGGGGGTGTGGGGTGCGGGCCCGTTACCCCCTTCCGGAGCTAAGTGGGTTACTCTTAACCAGGCGCACGTCGCACGCACCGGGCCGATGCGCGTCTGGCGTCCCCCTGCCGCAGCGCCCC	Cassette7_1
GGGGGGTGTGGGGTGCGGGCCCGTTACCCCCTTCCGGAGCTAAGTGGGTGCATCTTAACCAGGCGCACGTCGCACGCACCGGGCCGATGCGCGTCTGGCGTCCCCCTGCCGCAGCGCCCC	Cassette7_2
GGGGGGTGTGGGGTGCGGGCCCGTTACCCCCTTCCGGAGCTAAGTGGGTTCATCTTAACCAGGCGCACGTCGCACGCACCGGGCCGATGCGCGTCTGGCGTCCCCCTGCCGCAGCGCCCC	Cassette7_2
GGGGGGTGTGGGGTGCGGGCCCGTTACCCCCTTCCGGAGCTAAGTGGGTGGCGCTTAACCAGGCGCACGTCGCACGCACCGGGCCGATGCGCGTCTGGCGTCCCCCTGCCGCAGCGCCCC	Cassette7_3
GGGGGGTGTGGGGTGCGGGCCCGTTACCCCCTTCCGGAGCTAAGTGGGTGTCGCTTAACCAGGCGCACGTCGCACGCACCGGGCCGATGCGCGTCTGGCGTCCCCCTGCCGCAGCGCCCC	Cassette7_3
GGGGGGTGTGGGGTGCGGGCCCGTTACCCCCTTCCGGAGCTAAGTGGGATCGGCTTAACCAGGCGCACGTCGCACGCACCGGGCCGATGCGCGTCTGGCGTCCCCCTGCCGCAGCGCCCC	Cassette7_4
GGGGGGTGTGGGGTGCGGGCCCGTTACCCCCTTCCGGAGCTAAGTGGGATCTGCTTAACCAGGCGCACGTCGCACGCACCGGGCCGATGCGCGTCTGGCGTCCCCCTGCCGCAGCGCCCC	Cassette7_4
GGGGGGTGTGGGGTGCGGGCCCGTTACCCCCTTCCGGAGCTAAGTGGGAGAAGCTTAACCAGGCGCACGTCGCACGCACCGGGCCGATGCGCGTCTGGCGTCCCCCTGCCGCAGCGCCCC	Cassette7_5
GGGGGGTGTGGGGTGCGGGCCCGTTACCCCCTTCCGGAGCTAAGTGGGAGAATCTTAACCAGGCGCACGTCGCACGCACCGGGCCGATGCGCGTCTGGCGTCCCCCTGCCGCAGCGCCCC	Cassette7_5
GGGGGGTGTGGGGTGCGGGCCCGTTACCCCCTTCCGGAGCTAAGTGGGTTAAGGTTAACCAGGCGCACGTCGCACGCACCGGGCCGATGCGCGTCTGGCGTCCCCCTGCCGCAGCGCCCC	Cassette7_6
GGGGGGTGTGGGGTGCGGGCCCGTTACCCCCTTCCGGAGCTAAGTGGGTTAAGTTTAACCAGGCGCACGTCGCACGCACCGGGCCGATGCGCGTCTGGCGTCCCCCTGCCGCAGCGCCCC	Cassette7_6
GGGGGGTGTGGGGTGCGGGCCCGTTACCCCCTTCCGGAGCTAAGTGGGTTCCTAGTAACCAGGCGCACGTCGCACGCACCGGGCCGATGCGCGTCTGGCGTCCCCCTGCCGCAGCGCCCC	Cassette7_7
GGGGGGTGTGGGGTGCGGGCCCGTTACCCCCTTCCGGAGCTAAGTGGGTTCCTATTAACCAGGCGCACGTCGCACGCACCGGGCCGATGCGCGTCTGGCGTCCCCCTGCCGCAGCGCCCC	Cassette7_7
GGGGGGTGTGGGGTGCGGGCCCGTTACCCCCTTCCGGAGCTAAGTGGGTGCAGATGAACCAGGCGCACGTCGCACGCACCGGGCCGATGCGCGTCTGGCGTCCCCCTGCCGCAGCGCCCC	Cassette7_8
GGGGGGTGTGGGGTGCGGGCCCGTTACCCCCTTCCGGAGCTAAGTGGGTGCAGATTAACCAGGCGCACGTCGCACGCACCGGGCCGATGCGCGTCTGGCGTCCCCCTGCCGCAGCGCCCC	Cassette7_8
GGGGGGTGTGGGGTGCGGGCCCGTTACCCCCTTCCGGAGCTAAGTGGGAGCCTCTTGCTCAGGCGCACGTCGCACGCACCGGGCCGATGCGCGTCTGGCGTCCCCCTGCCGCAGCGCCCC	Cassette8_1
GGGGGGTGTGGGGTGCGGGCCCGTTACCCCCTTCCGGAGCTAAGTGGGAGCCTCTTTCTCAGGCGCACGTCGCACGCACCGGGCCGATGCGCGTCTGGCGTCCCCCTGCCGCAGCGCCCC	Cassette8_1
GGGGGGTGTGGGGTGCGGGCCCGTTACCCCCTTCCGGAGCTAAGTGGGAGCCTCTTCGCTAGGCGCACGTCGCACGCACCGGGCCGATGCGCGTCTGGCGTCCCCCTGCCGCAGCGCCCC	Cassette8_2
GGGGGGTGTGGGGTGCGGGCCCGTTACCCCCTTCCGGAGCTAAGTGGGAGCCTCTTCTCTAGGCGCACGTCGCACGCACCGGGCCGATGCGCGTCTGGCGTCCCCCTGCCGCAGCGCCCC	Cassette8_2
GGGGGGTGTGGGGTGCGGGCCCGTTACCCCCTTCCGGAGCTAAGTGGGAGCCTCTTCAGCCGGCGCACGTCGCACGCACCGGGCCGATGCGCGTCTGGCGTCCCCCTGCCGCAGCGCCCC	Cassette8_3
GGGGGGTGTGGGGTGCGGGCCCGTTACCCCCTTCCGGAGCTAAGTGGGAGCCTCTTCATCCGGCGCACGTCGCACGCACCGGGCCGATGCGCGTCTGGCGTCCCCCTGCCGCAGCGCCCC	Cassette8_3
GGGGGGTGTGGGGTGCGGGCCCGTTACCCCCTTCCGGAGCTAAGTGGGAGCCTCTTACCGCGGCGCACGTCGCACGCACCGGGCCGATGCGCGTCTGGCGTCCCCCTGCCGCAGCGCCCC	Cassette8_4
GGGGGGTGTGGGGTGCGGGCCCGTTACCCCCTTCCGGAGCTAAGTGGGAGCCTCTTACCTCGGCGCACGTCGCACGCACCGGGCCGATGCGCGTCTGGCGTCCCCCTGCCGCAGCGCCCC	Cassette8_4
GGGGGGTGTGGGGTGCGGGCCCGTTACCCCCTTCCGGAGCTAAGTGGGAGCCTCTTAATTGGGCGCACGTCGCACGCACCGGGCCGATGCGCGTCTGGCGTCCCCCTGCCGCAGCGCCCC	Cassette8_5
GGGGGGTGTGGGGTGCGGGCCCGTTACCCCCTTCCGGAGCTAAGTGGGAGCCTCTTAATTTGGCGCACGTCGCACGCACCGGGCCGATGCGCGTCTGGCGTCCCCCTGCCGCAGCGCCCC	Cassette8_5
GGGGGGTGTGGGGTGCGGGCCCGTTACCCCCTTCCGGAGCTAAGTGGGAGCCTCTTCCTTCGGCGCACGTCGCACGCACCGGGCCGATGCGCGTCTGGCGTCCCCCTGCCGCAGCGCCCC	Cassette8_6
GGGGGGTGTGGGGTGCGGGCCCGTTACCCCCTTCCGGAGCTAAGTGGGAGCCTCTTCCTTCTGCGCACGTCGCACGCACCGGGCCGATGCGCGTCTGGCGTCCCCCTGCCGCAGCGCCCC	Cassette8_6
GGGGGGTGTGGGGTGCGGGCCCGTTACCCCCTTCCGGAGCTAAGTGGGAGCCTCTTCACTCAGCGCACGTCGCACGCACCGGGCCGATGCGCGTCTGGCGTCCCCCTGCCGCAGCGCCCC	Cassette8_7
GGGGGGTGTGGGGTGCGGGCCCGTTACCCCCTTCCGGAGCTAAGTGGGAGCCTCTTCACTCATCGCACGTCGCACGCACCGGGCCGATGCGCGTCTGGCGTCCCCCTGCCGCAGCGCCCC	Cassette8_7
GGGGGGTGTGGGGTGCGGGCCCGTTACCCCCTTCCGGAGCTAAGTGGGAGCCTCTTCACCAAGGGCACGTCGCACGCACCGGGCCGATGCGCGTCTGGCGTCCCCCTGCCGCAGCGCCCC	Cassette8_8
GGGGGGTGTGGGGTGCGGGCCCGTTACCCCCTTCCGGAGCTAAGTGGGAGCCTCTTCACCAAGTGCACGTCGCACGCACCGGGCCGATGCGCGTCTGGCGTCCCCCTGCCGCAGCGCCCC	Cassette8_8
GGGGGGTGTGGGGTGCGGGCCCGTTACCCCCTTCCGGAGCTAAGTGGGAGCCTCTTAACCAGGCGTGCGTCGCACGCACCGGGCCGATGCGCGTCTGGCGTCCCCCTGCCGCAGCGCCCC	Cassette9_1
GGGGGGTGTGGGGTGCGGGCCCGTTACCCCCTTCCGGAGCTAAGTGGGAGCCTCTTAACCAGGCTTGCGTCGCACGCACCGGGCCGATGCGCGTCTGGCGTCCCCCTGCCGCAGCGCCCC	Cassette9_1
GGGGGGTGTGGGGTGCGGGCCCGTTACCCCCTTCCGGAGCTAAGTGGGAGCCTCTTAACCAGGCAGAAGTCGCACGCACCGGGCCGATGCGCGTCTGGCGTCCCCCTGCCGCAGCGCCCC	Cassette9_2
GGGGGGTGTGGGGTGCGGGCCCGTTACCCCCTTCCGGAGCTAAGTGGGAGCCTCTTAACCAGGCATAAGTCGCACGCACCGGGCCGATGCGCGTCTGGCGTCCCCCTGCCGCAGCGCCCC	Cassette9_2
GGGGGGTGTGGGGTGCGGGCCCGTTACCCCCTTCCGGAGCTAAGTGGGAGCCTCTTAACCAGGCACGCCTCGCACGCACCGGGCCGATGCGCGTCTGGCGTCCCCCTGCCGCAGCGCCCC	Cassette9_3
GGGGGGTGTGGGGTGCGGGCCCGTTACCCCCTTCCGGAGCTAAGTGGGAGCCTCTTAACCAGGCACTCCTCGCACGCACCGGGCCGATGCGCGTCTGGCGTCCCCCTGCCGCAGCGCCCC	Cassette9_3
GGGGGGTGTGGGGTGCGGGCCCGTTACCCCCTTCCGGAGCTAAGTGGGAGCCTCTTAACCAGGCGTAGCTCGCACGCACCGGGCCGATGCGCGTCTGGCGTCCCCCTGCCGCAGCGCCCC	Cassette9_4
GGGGGGTGTGGGGTGCGGGCCCGTTACCCCCTTCCGGAGCTAAGTGGGAGCCTCTTAACCAGGCGTATCTCGCACGCACCGGGCCGATGCGCGTCTGGCGTCCCCCTGCCGCAGCGCCCC	Cassette9_4
GGGGGGTGTGGGGTGCGGGCCCGTTACCCCCTTCCGGAGCTAAGTGGGAGCCTCTTAACCAGGCGCGAGTCGCACGCACCGGGCCGATGCGCGTCTGGCGTCCCCCTGCCGCAGCGCCCC	Cassette9_5
GGGGGGTGTGGGGTGCGGGCCCGTTACCCCCTTCCGGAGCTAAGTGGGAGCCTCTTAACCAGGCGCGATTCGCACGCACCGGGCCGATGCGCGTCTGGCGTCCCCCTGCCGCAGCGCCCC	Cassette9_5
GGGGGGTGTGGGGTGCGGGCCCGTTACCCCCTTCCGGAGCTAAGTGGGAGCCTCTTAACCAGGCATGACGCGCACGCACCGGGCCGATGCGCGTCTGGCGTCCCCCTGCCGCAGCGCCCC	Cassette9_6
GGGGGGTGTGGGGTGCGGGCCCGTTACCCCCTTCCGGAGCTAAGTGGGAGCCTCTTAACCAGGCATGACTCGCACGCACCGGGCCGATGCGCGTCTGGCGTCCCCCTGCCGCAGCGCCCC	Cassette9_6
GGGGGGTGTGGGGTGCGGGCCCGTTACCCCCTTCCGGAGCTAAGTGGGAGCCTCTTAACCAGGCATACCCGGCACGCACCGGGCCGATGCGCGTCTGGCGTCCCCCTGCCGCAGCGCCCC	Cassette9_7
GGGGGGTGTGGGGTGCGGGCCCGTTACCCCCTTCCGGAGCTAAGTGGGAGCCTCTTAACCAGGCATACCCTGCACGCACCGGGCCGATGCGCGTCTGGCGTCCCCCTGCCGCAGCGCCCC	Cassette9_7
GGGGGGTGTGGGGTGCGGGCCCGTTACCCCCTTCCGGAGCTAAGTGGGAGCCTCTTAACCAGGCACGAGCCGCACGCACCGGGCCGATGCGCGTCTGGCGTCCCCCTGCCGCAGCGCCCC	Cassette9_8
GGGGGGTGTGGGGTGCGGGCCCGTTACCCCCTTCCGGAGCTAAGTGGGAGCCTCTTAACCAGGCACGAGCCTCACGCACCGGGCCGATGCGCGTCTGGCGTCCCCCTGCCGCAGCGCCCC	Cassette9_8
GGGGGGTGTGGGGTGCGGGCCCGTTACCCCCTTCCGGAGCTAAGTGGGAGCCTCTTAACCAGGCGCACGTCGGGTGCACCGGGCCGATGCGCGTCTGGCGTCCCCCTGCCGCAGCGCCCC	Cassette10_1
GGGGGGTGTGGGGTGCGGGCCCGTTACCCCCTTCCGGAGCTAAGTGGGAGCCTCTTAACCAGGCGCACGTCGTGTGCACCGGGCCGATGCGCGTCTGGCGTCCCCCTGCCGCAGCGCCCC	Cassette10_1
GGGGGGTGTGGGGTGCGGGCCCGTTACCCCCTTCCGGAGCTAAGTGGGAGCCTCTTAACCAGGCGCACGTCGTGCCCACCGGGCCGATGCGCGTCTGGCGTCCCCCTGCCGCAGCGCCCC	Cassette10_2
GGGGGGTGTGGGGTGCGGGCCCGTTACCCCCTTCCGGAGCTAAGTGGGAGCCTCTTAACCAGGCGCACGTCGTTCCCACCGGGCCGATGCGCGTCTGGCGTCCCCCTGCCGCAGCGCCCC	Cassette10_2
GGGGGGTGTGGGGTGCGGGCCCGTTACCCCCTTCCGGAGCTAAGTGGGAGCCTCTTAACCAGGCGCACGTCGTAGGTACCGGGCCGATGCGCGTCTGGCGTCCCCCTGCCGCAGCGCCCC	Cassette10_3
GGGGGGTGTGGGGTGCGGGCCCGTTACCCCCTTCCGGAGCTAAGTGGGAGCCTCTTAACCAGGCGCACGTCGTATGTACCGGGCCGATGCGCGTCTGGCGTCCCCCTGCCGCAGCGCCCC	Cassette10_3
GGGGGGTGTGGGGTGCGGGCCCGTTACCCCCTTCCGGAGCTAAGTGGGAGCCTCTTAACCAGGCGCACGTCGCGCGTACCGGGCCGATGCGCGTCTGGCGTCCCCCTGCCGCAGCGCCCC	Cassette10_4
GGGGGGTGTGGGGTGCGGGCCCGTTACCCCCTTCCGGAGCTAAGTGGGAGCCTCTTAACCAGGCGCACGTCGCGCTTACCGGGCCGATGCGCGTCTGGCGTCCCCCTGCCGCAGCGCCCC	Cassette10_4
GGGGGGTGTGGGGTGCGGGCCCGTTACCCCCTTCCGGAGCTAAGTGGGAGCCTCTTAACCAGGCGCACGTCGCATCGACCGGGCCGATGCGCGTCTGGCGTCCCCCTGCCGCAGCGCCCC	Cassette10_5
GGGGGGTGTGGGGTGCGGGCCCGTTACCCCCTTCCGGAGCTAAGTGGGAGCCTCTTAACCAGGCGCACGTCGCATCTACCGGGCCGATGCGCGTCTGGCGTCCCCCTGCCGCAGCGCCCC	Cassette10_5
GGGGGGTGTGGGGTGCGGGCCCGTTACCCCCTTCCGGAGCTAAGTGGGAGCCTCTTAACCAGGCGCACGTCGTGTCTGCCGGGCCGATGCGCGTCTGGCGTCCCCCTGCCGCAGCGCCCC	Cassette10_6
GGGGGGTGTGGGGTGCGGGCCCGTTACCCCCTTCCGGAGCTAAGTGGGAGCCTCTTAACCAGGCGCACGTCGTGTCTTCCGGGCCGATGCGCGTCTGGCGTCCCCCTGCCGCAGCGCCCC	Cassette10_6
GGGGGGTGTGGGGTGCGGGCCCGTTACCCCCTTCCGGAGCTAAGTGGGAGCCTCTTAACCAGGCGCACGTCGTGCGCCGCGGGCCGATGCGCGTCTGGCGTCCCCCTGCCGCAGCGCCCC	Cassette10_7
GGGGGGTGTGGGGTGCGGGCCCGTTACCCCCTTCCGGAGCTAAGTGGGAGCCTCTTAACCAGGCGCACGTCGTGCGCCTCGGGCCGATGCGCGTCTGGCGTCCCCCTGCCGCAGCGCCCC	Cassette10_7
GGGGGGTGTGGGGTGCGGGCCCGTTACCCCCTTCCGGAGCTAAGTGGGAGCCTCTTAACCAGGCGCACGTCGTATCCCCGGGGCCGATGCGCGTCTGGCGTCCCCCTGCCGCAGCGCCCC	Cassette10_8
GGGGGGTGTGGGGTGCGGGCCCGTTACCCCCTTCCGGAGCTAAGTGGGAGCCTCTTAACCAGGCGCACGTCGTATCCCCTGGGCCGATGCGCGTCTGGCGTCCCCCTGCCGCAGCGCCCC	Cassette10_8
GGGGGGTGTGGGGTGCGGGCCCGTTACCCCCTTCCGGAGCTAAGTGGGAGCCTCTTAACCAGGCGCACGTCGCACGCACCGACCCGATGCGCGTCTGGCGTCCCCCTGCCGCAGCGCCCC	Cassette11_1
GGGGGGTGTGGGGTGCGGGCCCGTTACCCCCTTCCGGAGCTAAGTGGGAGCCTCTTAACCAGGCGCACGTCGCACGCACCTACCCGATGCGCGTCTGGCGTCCCCCTGCCGCAGCGCCCC	Cassette11_1
GGGGGGTGTGGGGTGCGGGCCCGTTACCCCCTTCCGGAGCTAAGTGGGAGCCTCTTAACCAGGCGCACGTCGCACGCACCGGCTTGATGCGCGTCTGGCGTCCCCCTGCCGCAGCGCCCC	Cassette11_2
GGGGGGTGTGGGGTGCGGGCCCGTTACCCCCTTCCGGAGCTAAGTGGGAGCCTCTTAACCAGGCGCACGTCGCACGCACCGTCTTGATGCGCGTCTGGCGTCCCCCTGCCGCAGCGCCCC	Cassette11_2
GGGGGGTGTGGGGTGCGGGCCCGTTACCCCCTTCCGGAGCTAAGTGGGAGCCTCTTAACCAGGCGCACGTCGCACGCACCGGGCTCATGCGCGTCTGGCGTCCCCCTGCCGCAGCGCCCC	Cassette11_3
GGGGGGTGTGGGGTGCGGGCCCGTTACCCCCTTCCGGAGCTAAGTGGGAGCCTCTTAACCAGGCGCACGTCGCACGCACCGGTCTCATGCGCGTCTGGCGTCCCCCTGCCGCAGCGCCCC	Cassette11_3
GGGGGGTGTGGGGTGCGGGCCCGTTACCCCCTTCCGGAGCTAAGTGGGAGCCTCTTAACCAGGCGCACGTCGCACGCACCGAGGCCATGCGCGTCTGGCGTCCCCCTGCCGCAGCGCCCC	Cassette11_4
GGGGGGTGTGGGGTGCGGGCCCGTTACCCCCTTCCGGAGCTAAGTGGGAGCCTCTTAACCAGGCGCACGTCGCACGCACCGAGTCCATGCGCGTCTGGCGTCCCCCTGCCGCAGCGCCCC	Cassette11_4
GGGGGGTGTGGGGTGCGGGCCCGTTACCCCCTTCCGGAGCTAAGTGGGAGCCTCTTAACCAGGCGCACGTCGCACGCACCGGCCGGGTGCGCGTCTGGCGTCCCCCTGCCGCAGCGCCCC	Cassette11_5
GGGGGGTGTGGGGTGCGGGCCCGTTACCCCCTTCCGGAGCTAAGTGGGAGCCTCTTAACCAGGCGCACGTCGCACGCACCGGCCTGGTGCGCGTCTGGCGTCCCCCTGCCGCAGCGCCCC	Cassette11_5
GGGGGGTGTGGGGTGCGGGCCCGTTACCCCCTTCCGGAGCTAAGTGGGAGCCTCTTAACCAGGCGCACGTCGCACGCACCGGGTCGGTGCGCGTCTGGCGTCCCCCTGCCGCAGCGCCCC	Cassette11_6
GGGGGGTGTGGGGTGCGGGCCCGTTACCCCCTTCCGGAGCTAAGTGGGAGCCTCTTAACCAGGCGCACGTCGCACGCACCGGGTCTGTGCGCGTCTGGCGTCCCCCTGCCGCAGCGCCCC	Cassette11_6
GGGGGGTGTGGGGTGCGGGCCCGTTACCCCCTTCCGGAGCTAAGTGGGAGCCTCTTAACCAGGCGCACGTCGCACGCACCGAGCTGGTGCGCGTCTGGCGTCCCCCTGCCGCAGCGCCCC	Cassette11_7
GGGGGGTGTGGGGTGCGGGCCCGTTACCCCCTTCCGGAGCTAAGTGGGAGCCTCTTAACCAGGCGCACGTCGCACGCACCGAGCTGTTGCGCGTCTGGCGTCCCCCTGCCGCAGCGCCCC	Cassette11_7
GGGGGGTGTGGGGTGCGGGCCCGTTACCCCCTTCCGGAGCTAAGTGGGAGCCTCTTAACCAGGCGCACGTCGCACGCACCGGCTCCAGGCGCGTCTGGCGTCCCCCTGCCGCAGCGCCCC	Cassette11_8
GGGGGGTGTGGGGTGCGGGCCCGTTACCCCCTTCCGGAGCTAAGTGGGAGCCTCTTAACCAGGCGCACGTCGCACGCACCGGCTCCATGCGCGTCTGGCGTCCCCCTGCCGCAGCGCCCC	Cassette11_8
GGGGGGTGTGGGGTGCGGGCCCGTTACCCCCTTCCGGAGCTAAGTGGGAGCCTCTTAACCAGGCGCACGTCGCACGCACCGGGCCGATGTCCGTCTGGCGTCCCCCTGCCGCAGCGCCCC	Cassette12_1
GGGGGGTGTGGGGTGCGGGCCCGTTACCCCCTTCCGGAGCTAAGTGGGAGCCTCTTAACCAGGCGCACGTCGCACGCACCGGGCCGATTTCCGTCTGGCGTCCCCCTGCCGCAGCGCCCC	Cassette12_1
GGGGGGTGTGGGGTGCGGGCCCGTTACCCCCTTCCGGAGCTAAGTGGGAGCCTCTTAACCAGGCGCACGTCGCACGCACCGGGCCGATAGGAGTCTGGCGTCCCCCTGCCGCAGCGCCCC	Cassette12_2
GGGGGGTGTGGGGTGCGGGCCCGTTACCCCCTTCCGGAGCTAAGTGGGAGCCTCTTAACCAGGCGCACGTCGCACGCACCGGGCCGATATGAGTCTGGCGTCCCCCTGCCGCAGCGCCCC	Cassette12_2
GGGGGGTGTGGGGTGCGGGCCCGTTACCCCCTTCCGGAGCTAAGTGGGAGCCTCTTAACCAGGCGCACGTCGCACGCACCGGGCCGATGTGAATCTGGCGTCCCCCTGCCGCAGCGCCCC	Cassette12_3
GGGGGGTGTGGGGTGCGGGCCCGTTACCCCCTTCCGGAGCTAAGTGGGAGCCTCTTAACCAGGCGCACGTCGCACGCACCGGGCCGATGTTAATCTGGCGTCCCCCTGCCGCAGCGCCCC	Cassette12_3
GGGGGGTGTGGGGTGCGGGCCCGTTACCCCCTTCCGGAGCTAAGTGGGAGCCTCTTAACCAGGCGCACGTCGCACGCACCGGGCCGATACCGATCTGGCGTCCCCCTGCCGCAGCGCCCC	Cassette12_4
GGGGGGTGTGGGGTGCGGGCCCGTTACCCCCTTCCGGAGCTAAGTGGGAGCCTCTTAACCAGGCGCACGTCGCACGCACCGGGCCGATACCTATCTGGCGTCCCCCTGCCGCAGCGCCCC	Cassette12_4
GGGGGGTGTGGGGTGCGGGCCCGTTACCCCCTTCCGGAGCTAAGTGGGAGCCTCTTAACCAGGCGCACGTCGCACGCACCGGGCCGATGTGCGCCTGGCGTCCCCCTGCCGCAGCGCCCC	Cassette12_5
GGGGGGTGTGGGGTGCGGGCCCGTTACCCCCTTCCGGAGCTAAGTGGGAGCCTCTTAACCAGGCGCACGTCGCACGCACCGGGCCGATGTGCTCCTGGCGTCCCCCTGCCGCAGCGCCCC	Cassette12_5
GGGGGGTGTGGGGTGCGGGCCCGTTACCCCCTTCCGGAGCTAAGTGGGAGCCTCTTAACCAGGCGCACGTCGCACGCACCGGGCCGATGCCAGGCTGGCGTCCCCCTGCCGCAGCGCCCC	Cassette12_6
GGGGGGTGTGGGGTGCGGGCCCGTTACCCCCTTCCGGAGCTAAGTGGGAGCCTCTTAACCAGGCGCACGTCGCACGCACCGGGCCGATGCCAGTCTGGCGTCCCCCTGCCGCAGCGCCCC	Cassette12_6
GGGGGGTGTGGGGTGCGGGCCCGTTACCCCCTTCCGGAGCTAAGTGGGAGCCTCTTAACCAGGCGCACGTCGCACGCACCGGGCCGATATGCATGTGGCGTCCCCCTGCCGCAGCGCCCC	Cassette12_7
GGGGGGTGTGGGGTGCGGGCCCGTTACCCCCTTCCGGAGCTAAGTGGGAGCCTCTTAACCAGGCGCACGTCGCACGCACCGGGCCGATATGCATTTGGCGTCCCCCTGCCGCAGCGCCCC	Cassette12_7
GGGGGGTGTGGGGTGCGGGCCCGTTACCCCCTTCCGGAGCTAAGTGGGAGCCTCTTAACCAGGCGCACGTCGCACGCACCGGGCCGATGCCCACCGGGCGTCCCCCTGCCGCAGCGCCCC	Cassette12_8
GGGGGGTGTGGGGTGCGGGCCCGTTACCCCCTTCCGGAGCTAAGTGGGAGCCTCTTAACCAGGCGCACGTCGCACGCACCGGGCCGATGCCCACCTGGCGTCCCCCTGCCGCAGCGCCCC	Cassette12_8
GGGGGGTGTGGGGTGCGGGCCCGTTACCCCCTTCCGGAGCTAAGTGGGAGCCTCTTAACCAGGCGCACGTCGCACGCACCGGGCCGATGCGCGTCTGATGTCCCCCTGCCGCAGCGCCCC	Cassette13_1
GGGGGGTGTGGGGTGCGGGCCCGTTACCCCCTTCCGGAGCTAAGTGGGAGCCTCTTAACCAGGCGCACGTCGCACGCACCGGGCCGATGCGCGTCTTATGTCCCCCTGCCGCAGCGCCCC	Cassette13_1
GGGGGGTGTGGGGTGCGGGCCCGTTACCCCCTTCCGGAGCTAAGTGGGAGCCTCTTAACCAGGCGCACGTCGCACGCACCGGGCCGATGCGCGTCTAGCTTCCCCCTGCCGCAGCGCCCC	Cassette13_2
GGGGGGTGTGGGGTGCGGGCCCGTTACCCCCTTCCGGAGCTAAGTGGGAGCCTCTTAACCAGGCGCACGTCGCACGCACCGGGCCGATGCGCGTCTATCTTCCCCCTGCCGCAGCGCCCC	Cassette13_2
GGGGGGTGTGGGGTGCGGGCCCGTTACCCCCTTCCGGAGCTAAGTGGGAGCCTCTTAACCAGGCGCACGTCGCACGCACCGGGCCGATGCGCGTCTAGGGCCCCCCTGCCGCAGCGCCCC	Cassette13_3
GGGGGGTGTGGGGTGCGGGCCCGTTACCCCCTTCCGGAGCTAAGTGGGAGCCTCTTAACCAGGCGCACGTCGCACGCACCGGGCCGATGCGCGTCTAGTGCCCCCCTGCCGCAGCGCCCC	Cassette13_3
GGGGGGTGTGGGGTGCGGGCCCGTTACCCCCTTCCGGAGCTAAGTGGGAGCCTCTTAACCAGGCGCACGTCGCACGCACCGGGCCGATGCGCGTCTGACGCCCCCCTGCCGCAGCGCCCC	Cassette13_4
GGGGGGTGTGGGGTGCGGGCCCGTTACCCCCTTCCGGAGCTAAGTGGGAGCCTCTTAACCAGGCGCACGTCGCACGCACCGGGCCGATGCGCGTCTGACTCCCCCCTGCCGCAGCGCCCC	Cassette13_4
GGGGGGTGTGGGGTGCGGGCCCGTTACCCCCTTCCGGAGCTAAGTGGGAGCCTCTTAACCAGGCGCACGTCGCACGCACCGGGCCGATGCGCGTCTGGTTGCCCCCTGCCGCAGCGCCCC	Cassette13_5
GGGGGGTGTGGGGTGCGGGCCCGTTACCCCCTTCCGGAGCTAAGTGGGAGCCTCTTAACCAGGCGCACGTCGCACGCACCGGGCCGATGCGCGTCTGGTTTCCCCCTGCCGCAGCGCCCC	Cassette13_5
GGGGGGTGTGGGGTGCGGGCCCGTTACCCCCTTCCGGAGCTAAGTGGGAGCCTCTTAACCAGGCGCACGTCGCACGCACCGGGCCGATGCGCGTCTAATTCGCCCCTGCCGCAGCGCCCC	Cassette13_6
GGGGGGTGTGGGGTGCGGGCCCGTTACCCCCTTCCGGAGCTAAGTGGGAGCCTCTTAACCAGGCGCACGTCGCACGCACCGGGCCGATGCGCGTCTAATTCTCCCCTGCCGCAGCGCCCC	Cassette13_6
GGGGGGTGTGGGGTGCGGGCCCGTTACCCCCTTCCGGAGCTAAGTGGGAGCCTCTTAACCAGGCGCACGTCGCACGCACCGGGCCGATGCGCGTCTAGTTTTGCCCTGCCGCAGCGCCCC	Cassette13_7
GGGGGGTGTGGGGTGCGGGCCCGTTACCCCCTTCCGGAGCTAAGTGGGAGCCTCTTAACCAGGCGCACGTCGCACGCACCGGGCCGATGCGCGTCTAGTTTTTCCCTGCCGCAGCGCCCC	Cassette13_7
GGGGGGTGTGGGGTGCGGGCCCGTTACCCCCTTCCGGAGCTAAGTGGGAGCCTCTTAACCAGGCGCACGTCGCACGCACCGGGCCGATGCGCGTCTAGCTCTCGCCTGCCGCAGCGCCCC	Cassette13_8
GGGGGGTGTGGGGTGCGGGCCCGTTACCCCCTTCCGGAGCTAAGTGGGAGCCTCTTAACCAGGCGCACGTCGCACGCACCGGGCCGATGCGCGTCTAGCTCTCTCCTGCCGCAGCGCCCC	Cassette13_8
GGGGGGTGTGGGGTGCGGGCCCGTTACCCCCTTCCGGAGCTAAGTGGGAGCCTCTTAACCAGGCGCACGTCGCACGCACCGGGCCGATGCGCGTCTGGCGTCCCGTGGCCGCAGCGCCCC	Cassette14_1
GGGGGGTGTGGGGTGCGGGCCCGTTACCCCCTTCCGGAGCTAAGTGGGAGCCTCTTAACCAGGCGCACGTCGCACGCACCGGGCCGATGCGCGTCTGGCGTCCCTTGGCCGCAGCGCCCC	Cassette14_1
GGGGGGTGTGGGGTGCGGGCCCGTTACCCCCTTCCGGAGCTAAGTGGGAGCCTCTTAACCAGGCGCACGTCGCACGCACCGGGCCGATGCGCGTCTGGCGTCCCTGTGTCGCAGCGCCCC	Cassette14_2
GGGGGGTGTGGGGTGCGGGCCCGTTACCCCCTTCCGGAGCTAAGTGGGAGCCTCTTAACCAGGCGCACGTCGCACGCACCGGGCCGATGCGCGTCTGGCGTCCCTTTGTCGCAGCGCCCC	Cassette14_2
GGGGGGTGTGGGGTGCGGGCCCGTTACCCCCTTCCGGAGCTAAGTGGGAGCCTCTTAACCAGGCGCACGTCGCACGCACCGGGCCGATGCGCGTCTGGCGTCCCTCGGCAGCAGCGCCCC	Cassette14_3
GGGGGGTGTGGGGTGCGGGCCCGTTACCCCCTTCCGGAGCTAAGTGGGAGCCTCTTAACCAGGCGCACGTCGCACGCACCGGGCCGATGCGCGTCTGGCGTCCCTCTGCAGCAGCGCCCC	Cassette14_3
GGGGGGTGTGGGGTGCGGGCCCGTTACCCCCTTCCGGAGCTAAGTGGGAGCCTCTTAACCAGGCGCACGTCGCACGCACCGGGCCGATGCGCGTCTGGCGTCCCCCGGTCGCAGCGCCCC	Cassette14_4
GGGGGGTGTGGGGTGCGGGCCCGTTACCCCCTTCCGGAGCTAAGTGGGAGCCTCTTAACCAGGCGCACGTCGCACGCACCGGGCCGATGCGCGTCTGGCGTCCCCCGTTCGCAGCGCCCC	Cassette14_4
GGGGGGTGTGGGGTGCGGGCCCGTTACCCCCTTCCGGAGCTAAGTGGGAGCCTCTTAACCAGGCGCACGTCGCACGCACCGGGCCGATGCGCGTCTGGCGTCCCCTTGGAGCAGCGCCCC	Cassette14_5
GGGGGGTGTGGGGTGCGGGCCCGTTACCCCCTTCCGGAGCTAAGTGGGAGCCTCTTAACCAGGCGCACGTCGCACGCACCGGGCCGATGCGCGTCTGGCGTCCCCTTGTAGCAGCGCCCC	Cassette14_5
GGGGGGTGTGGGGTGCGGGCCCGTTACCCCCTTCCGGAGCTAAGTGGGAGCCTCTTAACCAGGCGCACGTCGCACGCACCGGGCCGATGCGCGTCTGGCGTCCCTTTGCGGTAGCGCCCC	Cassette14_6
GGGGGGTGTGGGGTGCGGGCCCGTTACCCCCTTCCGGAGCTAAGTGGGAGCCTCTTAACCAGGCGCACGTCGCACGCACCGGGCCGATGCGCGTCTGGCGTCCCTTTGCTGTAGCGCCCC	Cassette14_6
GGGGGGTGTGGGGTGCGGGCCCGTTACCCCCTTCCGGAGCTAAGTGGGAGCCTCTTAACCAGGCGCACGTCGCACGCACCGGGCCGATGCGCGTCTGGCGTCCCTTGGTAGCAGCGCCCC	Cassette14_7
GGGGGGTGTGGGGTGCGGGCCCGTTACCCCCTTCCGGAGCTAAGTGGGAGCCTCTTAACCAGGCGCACGTCGCACGCACCGGGCCGATGCGCGTCTGGCGTCCCTTGGTATCAGCGCCCC	Cassette14_7
GGGGGGTGTGGGGTGCGGGCCCGTTACCCCCTTCCGGAGCTAAGTGGGAGCCTCTTAACCAGGCGCACGTCGCACGCACCGGGCCGATGCGCGTCTGGCGTCCCTCGGCCGGAGCGCCCC	Cassette14_8
GGGGGGTGTGGGGTGCGGGCCCGTTACCCCCTTCCGGAGCTAAGTGGGAGCCTCTTAACCAGGCGCACGTCGCACGCACCGGGCCGATGCGCGTCTGGCGTCCCTCGGCCGTAGCGCCCC	Cassette14_8
GGGGGGTGTGGGGTGCGGGCCCGTTACCCCCTTCCGGAGCTAAGTGGGAGCCTCTTAACCAGGCGCACGTCGCACGCACCGGGCCGATGCGCGTCTGGCGTCCCCCTGCCGCGTAGCCCC	Cassette15_1
GGGGGGTGTGGGGTGCGGGCCCGTTACCCCCTTCCGGAGCTAAGTGGGAGCCTCTTAACCAGGCGCACGTCGCACGCACCGGGCCGATGCGCGTCTGGCGTCCCCCTGCCGCTTAGCCCC	Cassette15_1
GGGGGGTGTGGGGTGCGGGCCCGTTACCCCCTTCCGGAGCTAAGTGGGAGCCTCTTAACCAGGCGCACGTCGCACGCACCGGGCCGATGCGCGTCTGGCGTCCCCCTGCCGCGGCCCCCC	Cassette15_2
GGGGGGTGTGGGGTGCGGGCCCGTTACCCCCTTCCGGAGCTAAGTGGGAGCCTCTTAACCAGGCGCACGTCGCACGCACCGGGCCGATGCGCGTCTGGCGTCCCCCTGCCGCGTCCCCCC	Cassette15_2
GGGGGGTGTGGGGTGCGGGCCCGTTACCCCCTTCCGGAGCTAAGTGGGAGCCTCTTAACCAGGCGCACGTCGCACGCACCGGGCCGATGCGCGTCTGGCGTCCCCCTGCCGCATGCACCC	Cassette15_3
GGGGGGTGTGGGGTGCGGGCCCGTTACCCCCTTCCGGAGCTAAGTGGGAGCCTCTTAACCAGGCGCACGTCGCACGCACCGGGCCGATGCGCGTCTGGCGTCCCCCTGCCGCATTCACCC	Cassette15_3
GGGGGGTGTGGGGTGCGGGCCCGTTACCCCCTTCCGGAGCTAAGTGGGAGCCTCTTAACCAGGCGCACGTCGCACGCACCGGGCCGATGCGCGTCTGGCGTCCCCCTGCCGCGGAGACCC	Cassette15_4
GGGGGGTGTGGGGTGCGGGCCCGTTACCCCCTTCCGGAGCTAAGTGGGAGCCTCTTAACCAGGCGCACGTCGCACGCACCGGGCCGATGCGCGTCTGGCGTCCCCCTGCCGCGGATACCC	Cassette15_4
GGGGGGTGTGGGGTGCGGGCCCGTTACCCCCTTCCGGAGCTAAGTGGGAGCCTCTTAACCAGGCGCACGTCGCACGCACCGGGCCGATGCGCGTCTGGCGTCCCCCTGCCGCATCGGACC	Cassette15_5
GGGGGGTGTGGGGTGCGGGCCCGTTACCCCCTTCCGGAGCTAAGTGGGAGCCTCTTAACCAGGCGCACGTCGCACGCACCGGGCCGATGCGCGTCTGGCGTCCCCCTGCCGCATCGTACC	Cassette15_5
GGGGGGTGTGGGGTGCGGGCCCGTTACCCCCTTCCGGAGCTAAGTGGGAGCCTCTTAACCAGGCGCACGTCGCACGCACCGGGCCGATGCGCGTCTGGCGTCCCCCTGCCGCAGACCGCC	Cassette15_6
GGGGGGTGTGGGGTGCGGGCCCGTTACCCCCTTCCGGAGCTAAGTGGGAGCCTCTTAACCAGGCGCACGTCGCACGCACCGGGCCGATGCGCGTCTGGCGTCCCCCTGCCGCAGACCTCC	Cassette15_6
GGGGGGTGTGGGGTGCGGGCCCGTTACCCCCTTCCGGAGCTAAGTGGGAGCCTCTTAACCAGGCGCACGTCGCACGCACCGGGCCGATGCGCGTCTGGCGTCCCCCTGCCGCGTCGACGC	Cassette15_7
GGGGGGTGTGGGGTGCGGGCCCGTTACCCCCTTCCGGAGCTAAGTGGGAGCCTCTTAACCAGGCGCACGTCGCACGCACCGGGCCGATGCGCGTCTGGCGTCCCCCTGCCGCGTCGACTC	Cassette15_7
GGGGGGTGTGGGGTGCGGGCCCGTTACCCCCTTCCGGAGCTAAGTGGGAGCCTCTTAACCAGGCGCACGTCGCACGCACCGGGCCGATGCGCGTCTGGCGTCCCCCTGCCGCAGCCAACG	Cassette15_8
GGGGGGTGTGGGGTGCGGGCCCGTTACCCCCTTCCGGAGCTAAGTGGGAGCCTCTTAACCAGGCGCACGTCGCACGCACCGGGCCGATGCGCGTCTGGCGTCCCCCTGCCGCAGCCAACT	Cassette15_8
GGGGGGTGTGGGGTGCGGGCCCGTTACCCCCTTCCGGAGCTAAGTGGGAGCCTCTTAACCAGGCGCACGTCGCACGCACCGGGCCGATGCGCGTCTGGCGTCCCCCTGCCGCAGCGCCCC	WT
