barcode	position
GAAGCGCAAGGAGCCTTCACTTATCAAAACTCACTGGGGAAAGCGCGGCGCTTTCGTACCTGGTGCAGTCATCTCCCCATGGGTCGCCATACCCTTTCCACTTCCTGGTCGGGAACCTCT	Cassette1_1
TAAGCGCAAGGAGCCTTCACTTATCAAAACTCACTGGGGAAAGCGCGGCGCTTTCGTACCTGGTGCAGTCATCTCCCCATGGGTCGCCATACCCTTTCCACTTCCTGGTCGGGAACCTCT	Cassette1_1
AGGCCGCAAGGAGCCTTCACTTATCAAAACTCACTGGGGAAAGCGCGGCGCTTTCGTACCTGGTGCAGTCATCTCCCCATGGGTCGCCATACCCTTTCCACTTCCTGGTCGGGAACCTCT	Cassette1_2
ATGCCGCAAGGAGCCTTCACTTATCAAAACTCACTGGGGAAAGCGCGGCGCTTTCGTACCTGGTGCAGTCATCTCCCCATGGGTCGCCATACCCTTTCCACTTCCTGGTCGGGAACCTCT	Cassette1_2
AGGGAGCAAGGAGCCTTCACTTATCAAAACTCACTGGGGAAAGCGCGGCGCTTTCGTACCTGGTGCAGTCATCTCCCCATGGGTCGCCATACCCTTTCCACTTCCTGGTCGGGAACCTCT	Cassette1_3
AGTGAGCAAGGAGCCTTCACTTATCAAAACTCACTGGGGAAAGCGCGGCGCTTTCGTACCTGGTGCAGTCATCTCCCCATGGGTCGCCATACCCTTTCCACTTCCTGGTCGGGAACCTCT	Cassette1_3
GAGGAGCAAGGAGCCTTCACTTATCAAAACTCACTGGGGAAAGCGCGGCGCTTTCGTACCTGGTGCAGTCATCTCCCCATGGGTCGCCATACCCTTTCCACTTCCTGGTCGGGAACCTCT	Cassette1_4
GAGTAGCAAGGAGCCTTCACTTATCAAAACTCACTGGGGAAAGCGCGGCGCTTTCGTACCTGGTGCAGTCATCTCCCCATGGGTCGCCATACCCTTTCCACTTCCTGGTCGGGAACCTCT	Cassette1_4
GGACGGCAAGGAGCCTTCACTTATCAAAACTCACTGGGGAAAGCGCGGCGCTTTCGTACCTGGTGCAGTCATCTCCCCATGGGTCGCCATACCCTTTCCACTTCCTGGTCGGGAACCTCT	Cassette1_5
GGACTGCAAGGAGCCTTCACTTATCAAAACTCACTGGGGAAAGCGCGGCGCTTTCGTACCTGGTGCAGTCATCTCCCCATGGGTCGCCATACCCTTTCCACTTCCTGGTCGGGAACCTCT	Cassette1_5
AAACAGCAAGGAGCCTTCACTTATCAAAACTCACTGGGGAAAGCGCGGCGCTTTCGTACCTGGTGCAGTCATCTCCCCATGGGTCGCCATACCCTTTCCACTTCCTGGTCGGGAACCTCT	Cassette1_6
AAACATCAAGGAGCCTTCACTTATCAAAACTCACTGGGGAAAGCGCGGCGCTTTCGTACCTGGTGCAGTCATCTCCCCATGGGTCGCCATACCCTTTCCACTTCCTGGTCGGGAACCTCT	Cassette1_6
AAGGAAGAAGGAGCCTTCACTTATCAAAACTCACTGGGGAAAGCGCGGCGCTTTCGTACCTGGTGCAGTCATCTCCCCATGGGTCGCCATACCCTTTCCACTTCCTGGTCGGGAACCTCT	Cassette1_7
AAGGAATAAGGAGCCTTCACTTATCAAAACTCACTGGGGAAAGCGCGGCGCTTTCGTACCTGGTGCAGTCATCTCCCCATGGGTCGCCATACCCTTTCCACTTCCTGGTCGGGAACCTCT	Cassette1_7
AGACCACGAGGAGCCTTCACTTATCAAAACTCACTGGGGAAAGCGCGGCGCTTTCGTACCTGGTGCAGTCATCTCCCCATGGGTCGCCATACCCTTTCCACTTCCTGGTCGGGAACCTCT	Cassette1_8
AGACCACTAGGAGCCTTCACTTATCAAAACTCACTGGGGAAAGCGCGGCGCTTTCGTACCTGGTGCAGTCATCTCCCCATGGGTCGCCATACCCTTTCCACTTCCTGGTCGGGAACCTCT	Cassette1_8
GGGGCGCAGAAAGCCTTCACTTATCAAAACTCACTGGGGAAAGCGCGGCGCTTTCGTACCTGGTGCAGTCATCTCCCCATGGGTCGCCATACCCTTTCCACTTCCTGGTCGGGAACCTCT	Cassette2_1
GGGGCGCATAAAGCCTTCACTTATCAAAACTCACTGGGGAAAGCGCGGCGCTTTCGTACCTGGTGCAGTCATCTCCCCATGGGTCGCCATACCCTTTCCACTTCCTGGTCGGGAACCTCT	Cassette2_1
GGGGCGCACGGGGCCTTCACTTATCAAAACTCACTGGGGAAAGCGCGGCGCTTTCGTACCTGGTGCAGTCATCTCCCCATGGGTCGCCATACCCTTTCCACTTCCTGGTCGGGAACCTCT	Cassette2_2
GGGGCGCACTGGGCCTTCACTTATCAAAACTCACTGGGGAAAGCGCGGCGCTTTCGTACCTGGTGCAGTCATCTCCCCATGGGTCGCCATACCCTTTCCACTTCCTGGTCGGGAACCTCT	Cassette2_2
GGGGCGCAAGGGACCTTCACTTATCAAAACTCACTGGGGAAAGCGCGGCGCTTTCGTACCTGGTGCAGTCATCTCCCCATGGGTCGCCATACCCTTTCCACTTCCTGGTCGGGAACCTCT	Cassette2_3
GGGGCGCAAGTGACCTTCACTTATCAAAACTCACTGGGGAAAGCGCGGCGCTTTCGTACCTGGTGCAGTCATCTCCCCATGGGTCGCCATACCCTTTCCACTTCCTGGTCGGGAACCTCT	Cassette2_3
GGGGCGCAAGAGGTCTTCACTTATCAAAACTCACTGGGGAAAGCGCGGCGCTTTCGTACCTGGTGCAGTCATCTCCCCATGGGTCGCCATACCCTTTCCACTTCCTGGTCGGGAACCTCT	Cassette2_4
GGGGCGCAAGATGTCTTCACTTATCAAAACTCACTGGGGAAAGCGCGGCGCTTTCGTACCTGGTGCAGTCATCTCCCCATGGGTCGCCATACCCTTTCCACTTCCTGGTCGGGAACCTCT	Cassette2_4
GGGGCGCAAAGGGTCTTCACTTATCAAAACTCACTGGGGAAAGCGCGGCGCTTTCGTACCTGGTGCAGTCATCTCCCCATGGGTCGCCATACCCTTTCCACTTCCTGGTCGGGAACCTCT	Cassette2_5
GGGGCGCAAAGGTTCTTCACTTATCAAAACTCACTGGGGAAAGCGCGGCGCTTTCGTACCTGGTGCAGTCATCTCCCCATGGGTCGCCATACCCTTTCCACTTCCTGGTCGGGAACCTCT	Cassette2_5
GGGGCGCACGAAAGCTTCACTTATCAAAACTCACTGGGGAAAGCGCGGCGCTTTCGTACCTGGTGCAGTCATCTCCCCATGGGTCGCCATACCCTTTCCACTTCCTGGTCGGGAACCTCT	Cassette2_6
GGGGCGCACGAAATCTTCACTTATCAAAACTCACTGGGGAAAGCGCGGCGCTTTCGTACCTGGTGCAGTCATCTCCCCATGGGTCGCCATACCCTTTCCACTTCCTGGTCGGGAACCTCT	Cassette2_6
GGGGCGCAAAGAACGTTCACTTATCAAAACTCACTGGGGAAAGCGCGGCGCTTTCGTACCTGGTGCAGTCATCTCCCCATGGGTCGCCATACCCTTTCCACTTCCTGGTCGGGAACCTCT	Cassette2_7
GGGGCGCAAAGAACTTTCACTTATCAAAACTCACTGGGGAAAGCGCGGCGCTTTCGTACCTGGTGCAGTCATCTCCCCATGGGTCGCCATACCCTTTCCACTTCCTGGTCGGGAACCTCT	Cassette2_7
GGGGCGCACAAGACCGTCACTTATCAAAACTCACTGGGGAAAGCGCGGCGCTTTCGTACCTGGTGCAGTCATCTCCCCATGGGTCGCCATACCCTTTCCACTTCCTGGTCGGGAACCTCT	Cassette2_8
GGGGCGCACAAGACCTTCACTTATCAAAACTCACTGGGGAAAGCGCGGCGCTTTCGTACCTGGTGCAGTCATCTCCCCATGGGTCGCCATACCCTTTCCACTTCCTGGTCGGGAACCTCT	Cassette2_8
GGGGCGCAAGGAGCCTGAGCTTATCAAAACTCACTGGGGAAAGCGCGGCGCTTTCGTACCTGGTGCAGTCATCTCCCCATGGGTCGCCATACCCTTTCCACTTCCTGGTCGGGAACCTCT	Cassette3_1
GGGGCGCAAGGAGCCTTAGCTTATCAAAACTCACTGGGGAAAGCGCGGCGCTTTCGTACCTGGTGCAGTCATCTCCCCATGGGTCGCCATACCCTTTCCACTTCCTGGTCGGGAACCTCT	Cassette3_1
GGGGCGCAAGGAGCCTCGAATTATCAAAACTCACTGGGGAAAGCGCGGCGCTTTCGTACCTGGTGCAGTCATCTCCCCATGGGTCGCCATACCCTTTCCACTTCCTGGTCGGGAACCTCT	Cassette3_2
GGGGCGCAAGGAGCCTCTAATTATCAAAACTCACTGGGGAAAGCGCGGCGCTTTCGTACCTGGTGCAGTCATCTCCCCATGGGTCGCCATACCCTTTCCACTTCCTGGTCGGGAACCTCT	Cassette3_2
GGGGCGCAAGGAGCCTCCGCCTATCAAAACTCACTGGGGAAAGCGCGGCGCTTTCGTACCTGGTGCAGTCATCTCCCCATGGGTCGCCATACCCTTTCCACTTCCTGGTCGGGAACCTCT	Cassette3_3
GGGGCGCAAGGAGCCTCCTCCTATCAAAACTCACTGGGGAAAGCGCGGCGCTTTCGTACCTGGTGCAGTCATCTCCCCATGGGTCGCCATACCCTTTCCACTTCCTGGTCGGGAACCTCT	Cassette3_3
GGGGCGCAAGGAGCCTTAAGCTATCAAAACTCACTGGGGAAAGCGCGGCGCTTTCGTACCTGGTGCAGTCATCTCCCCATGGGTCGCCATACCCTTTCCACTTCCTGGTCGGGAACCTCT	Cassette3_4
GGGGCGCAAGGAGCCTTAATCTATCAAAACTCACTGGGGAAAGCGCGGCGCTTTCGTACCTGGTGCAGTCATCTCCCCATGGGTCGCCATACCCTTTCCACTTCCTGGTCGGGAACCTCT	Cassette3_4
GGGGCGCAAGGAGCCTTCGAGTATCAAAACTCACTGGGGAAAGCGCGGCGCTTTCGTACCTGGTGCAGTCATCTCCCCATGGGTCGCCATACCCTTTCCACTTCCTGGTCGGGAACCTCT	Cassette3_5
GGGGCGCAAGGAGCCTTCGATTATCAAAACTCACTGGGGAAAGCGCGGCGCTTTCGTACCTGGTGCAGTCATCTCCCCATGGGTCGCCATACCCTTTCCACTTCCTGGTCGGGAACCTCT	Cassette3_5
GGGGCGCAAGGAGCCTCAGACGATCAAAACTCACTGGGGAAAGCGCGGCGCTTTCGTACCTGGTGCAGTCATCTCCCCATGGGTCGCCATACCCTTTCCACTTCCTGGTCGGGAACCTCT	Cassette3_6
GGGGCGCAAGGAGCCTCAGACTATCAAAACTCACTGGGGAAAGCGCGGCGCTTTCGTACCTGGTGCAGTCATCTCCCCATGGGTCGCCATACCCTTTCCACTTCCTGGTCGGGAACCTCT	Cassette3_6
GGGGCGCAAGGAGCCTCAACCCGTCAAAACTCACTGGGGAAAGCGCGGCGCTTTCGTACCTGGTGCAGTCATCTCCCCATGGGTCGCCATACCCTTTCCACTTCCTGGTCGGGAACCTCT	Cassette3_7
GGGGCGCAAGGAGCCTCAACCCTTCAAAACTCACTGGGGAAAGCGCGGCGCTTTCGTACCTGGTGCAGTCATCTCCCCATGGGTCGCCATACCCTTTCCACTTCCTGGTCGGGAACCTCT	Cassette3_7
GGGGCGCAAGGAGCCTCCGATCAGCAAAACTCACTGGGGAAAGCGCGGCGCTTTCGTACCTGGTGCAGTCATCTCCCCATGGGTCGCCATACCCTTTCCACTTCCTGGTCGGGAACCTCT	Cassette3_8
GGGGCGCAAGGAGCCTCCGATCATCAAAACTCACTGGGGAAAGCGCGGCGCTTTCGTACCTGGTGCAGTCATCTCCCCATGGGTCGCCATACCCTTTCCACTTCCTGGTCGGGAACCTCT	Cassette3_8
GGGGCGCAAGGAGCCTTCACTTATGTTAACTCACTGGGGAAAGCGCGGCGCTTTCGTACCTGGTGCAGTCATCTCCCCATGGGTCGCCATACCCTTTCCACTTCCTGGTCGGGAACCTCT	Cassette4_1
GGGGCGCAAGGAGCCTTCACTTATTTTAACTCACTGGGGAAAGCGCGGCGCTTTCGTACCTGGTGCAGTCATCTCCCCATGGGTCGCCATACCCTTTCCACTTCCTGGTCGGGAACCTCT	Cassette4_1
GGGGCGCAAGGAGCCTTCACTTATTGACACTCACTGGGGAAAGCGCGGCGCTTTCGTACCTGGTGCAGTCATCTCCCCATGGGTCGCCATACCCTTTCCACTTCCTGGTCGGGAACCTCT	Cassette4_2
GGGGCGCAAGGAGCCTTCACTTATTTACACTCACTGGGGAAAGCGCGGCGCTTTCGTACCTGGTGCAGTCATCTCCCCATGGGTCGCCATACCCTTTCCACTTCCTGGTCGGGAACCTCT	Cassette4_2
GGGGCGCAAGGAGCCTTCACTTATCTGCTCTCACTGGGGAAAGCGCGGCGCTTTCGTACCTGGTGCAGTCATCTCCCCATGGGTCGCCATACCCTTTCCACTTCCTGGTCGGGAACCTCT	Cassette4_3
GGGGCGCAAGGAGCCTTCACTTATCTTCTCTCACTGGGGAAAGCGCGGCGCTTTCGTACCTGGTGCAGTCATCTCCCCATGGGTCGCCATACCCTTTCCACTTCCTGGTCGGGAACCTCT	Cassette4_3
GGGGCGCAAGGAGCCTTCACTTATTATGTCTCACTGGGGAAAGCGCGGCGCTTTCGTACCTGGTGCAGTCATCTCCCCATGGGTCGCCATACCCTTTCCACTTCCTGGTCGGGAACCTCT	Cassette4_4
GGGGCGCAAGGAGCCTTCACTTATTATTTCTCACTGGGGAAAGCGCGGCGCTTTCGTACCTGGTGCAGTCATCTCCCCATGGGTCGCCATACCCTTTCCACTTCCTGGTCGGGAACCTCT	Cassette4_4
GGGGCGCAAGGAGCCTTCACTTATCTAAGTTCACTGGGGAAAGCGCGGCGCTTTCGTACCTGGTGCAGTCATCTCCCCATGGGTCGCCATACCCTTTCCACTTCCTGGTCGGGAACCTCT	Cassette4_5
GGGGCGCAAGGAGCCTTCACTTATCTAATTTCACTGGGGAAAGCGCGGCGCTTTCGTACCTGGTGCAGTCATCTCCCCATGGGTCGCCATACCCTTTCCACTTCCTGGTCGGGAACCTCT	Cassette4_5
GGGGCGCAAGGAGCCTTCACTTATCATCAGTCACTGGGGAAAGCGCGGCGCTTTCGTACCTGGTGCAGTCATCTCCCCATGGGTCGCCATACCCTTTCCACTTCCTGGTCGGGAACCTCT	Cassette4_6
GGGGCGCAAGGAGCCTTCACTTATCATCATTCACTGGGGAAAGCGCGGCGCTTTCGTACCTGGTGCAGTCATCTCCCCATGGGTCGCCATACCCTTTCCACTTCCTGGTCGGGAACCTCT	Cassette4_6
GGGGCGCAAGGAGCCTTCACTTATTTAATCGCACTGGGGAAAGCGCGGCGCTTTCGTACCTGGTGCAGTCATCTCCCCATGGGTCGCCATACCCTTTCCACTTCCTGGTCGGGAACCTCT	Cassette4_7
GGGGCGCAAGGAGCCTTCACTTATTTAATCTCACTGGGGAAAGCGCGGCGCTTTCGTACCTGGTGCAGTCATCTCCCCATGGGTCGCCATACCCTTTCCACTTCCTGGTCGGGAACCTCT	Cassette4_7
GGGGCGCAAGGAGCCTTCACTTATCATATTTGACTGGGGAAAGCGCGGCGCTTTCGTACCTGGTGCAGTCATCTCCCCATGGGTCGCCATACCCTTTCCACTTCCTGGTCGGGAACCTCT	Cassette4_8
GGGGCGCAAGGAGCCTTCACTTATCATATTTTACTGGGGAAAGCGCGGCGCTTTCGTACCTGGTGCAGTCATCTCCCCATGGGTCGCCATACCCTTTCCACTTCCTGGTCGGGAACCTCT	Cassette4_8
GGGGCGCAAGGAGCCTTCACTTATCAAAACTCGAGGGGGAAAGCGCGGCGCTTTCGTACCTGGTGCAGTCATCTCCCCATGGGTCGCCATACCCTTTCCACTTCCTGGTCGGGAACCTCT	Cassette5_1
GGGGCGCAAGGAGCCTTCACTTATCAAAACTCTAGGGGGAAAGCGCGGCGCTTTCGTACCTGGTGCAGTCATCTCCCCATGGGTCGCCATACCCTTTCCACTTCCTGGTCGGGAACCTCT	Cassette5_1
GGGGCGCAAGGAGCCTTCACTTATCAAAACTCCGTGAGGAAAGCGCGGCGCTTTCGTACCTGGTGCAGTCATCTCCCCATGGGTCGCCATACCCTTTCCACTTCCTGGTCGGGAACCTCT	Cassette5_2
GGGGCGCAAGGAGCCTTCACTTATCAAAACTCCTTGAGGAAAGCGCGGCGCTTTCGTACCTGGTGCAGTCATCTCCCCATGGGTCGCCATACCCTTTCCACTTCCTGGTCGGGAACCTCT	Cassette5_2
GGGGCGCAAGGAGCCTTCACTTATCAAAACTCACGGAAGAAAGCGCGGCGCTTTCGTACCTGGTGCAGTCATCTCCCCATGGGTCGCCATACCCTTTCCACTTCCTGGTCGGGAACCTCT	Cassette5_3
GGGGCGCAAGGAGCCTTCACTTATCAAAACTCACTGAAGAAAGCGCGGCGCTTTCGTACCTGGTGCAGTCATCTCCCCATGGGTCGCCATACCCTTTCCACTTCCTGGTCGGGAACCTCT	Cassette5_3
GGGGCGCAAGGAGCCTTCACTTATCAAAACTCAATGGAGAAAGCGCGGCGCTTTCGTACCTGGTGCAGTCATCTCCCCATGGGTCGCCATACCCTTTCCACTTCCTGGTCGGGAACCTCT	Cassette5_4
GGGGCGCAAGGAGCCTTCACTTATCAAAACTCAATTGAGAAAGCGCGGCGCTTTCGTACCTGGTGCAGTCATCTCCCCATGGGTCGCCATACCCTTTCCACTTCCTGGTCGGGAACCTCT	Cassette5_4
GGGGCGCAAGGAGCCTTCACTTATCAAAACTCACGGGGAAAAGCGCGGCGCTTTCGTACCTGGTGCAGTCATCTCCCCATGGGTCGCCATACCCTTTCCACTTCCTGGTCGGGAACCTCT	Cassette5_5
GGGGCGCAAGGAGCCTTCACTTATCAAAACTCACGGTGAAAAGCGCGGCGCTTTCGTACCTGGTGCAGTCATCTCCCCATGGGTCGCCATACCCTTTCCACTTCCTGGTCGGGAACCTCT	Cassette5_5
GGGGCGCAAGGAGCCTTCACTTATCAAAACTCAATGAGAAAAGCGCGGCGCTTTCGTACCTGGTGCAGTCATCTCCCCATGGGTCGCCATACCCTTTCCACTTCCTGGTCGGGAACCTCT	Cassette5_6
GGGGCGCAAGGAGCCTTCACTTATCAAAACTCAATGATAAAAGCGCGGCGCTTTCGTACCTGGTGCAGTCATCTCCCCATGGGTCGCCATACCCTTTCCACTTCCTGGTCGGGAACCTCT	Cassette5_6
GGGGCGCAAGGAGCCTTCACTTATCAAAACTCCCTGGAGAAAGCGCGGCGCTTTCGTACCTGGTGCAGTCATCTCCCCATGGGTCGCCATACCCTTTCCACTTCCTGGTCGGGAACCTCT	Cassette5_7
GGGGCGCAAGGAGCCTTCACTTATCAAAACTCCCTGGATAAAGCGCGGCGCTTTCGTACCTGGTGCAGTCATCTCCCCATGGGTCGCCATACCCTTTCCACTTCCTGGTCGGGAACCTCT	Cassette5_7
GGGGCGCAAGGAGCCTTCACTTATCAAAACTCCAGGAAGGAAGCGCGGCGCTTTCGTACCTGGTGCAGTCATCTCCCCATGGGTCGCCATACCCTTTCCACTTCCTGGTCGGGAACCTCT	Cassette5_8
GGGGCGCAAGGAGCCTTCACTTATCAAAACTCCAGGAAGTAAGCGCGGCGCTTTCGTACCTGGTGCAGTCATCTCCCCATGGGTCGCCATACCCTTTCCACTTCCTGGTCGGGAACCTCT	Cassette5_8
GGGGCGCAAGGAGCCTTCACTTATCAAAACTCACTGGGGAGTACGCGGCGCTTTCGTACCTGGTGCAGTCATCTCCCCATGGGTCGCCATACCCTTTCCACTTCCTGGTCGGGAACCTCT	Cassette6_1
GGGGCGCAAGGAGCCTTCACTTATCAAAACTCACTGGGGATTACGCGGCGCTTTCGTACCTGGTGCAGTCATCTCCCCATGGGTCGCCATACCCTTTCCACTTCCTGGTCGGGAACCTCT	Cassette6_1
GGGGCGCAAGGAGCCTTCACTTATCAAAACTCACTGGGGATGGTGCGGCGCTTTCGTACCTGGTGCAGTCATCTCCCCATGGGTCGCCATACCCTTTCCACTTCCTGGTCGGGAACCTCT	Cassette6_2
GGGGCGCAAGGAGCCTTCACTTATCAAAACTCACTGGGGATTGTGCGGCGCTTTCGTACCTGGTGCAGTCATCTCCCCATGGGTCGCCATACCCTTTCCACTTCCTGGTCGGGAACCTCT	Cassette6_2
GGGGCGCAAGGAGCCTTCACTTATCAAAACTCACTGGGGATAGCCCGGCGCTTTCGTACCTGGTGCAGTCATCTCCCCATGGGTCGCCATACCCTTTCCACTTCCTGGTCGGGAACCTCT	Cassette6_3
GGGGCGCAAGGAGCCTTCACTTATCAAAACTCACTGGGGATATCCCGGCGCTTTCGTACCTGGTGCAGTCATCTCCCCATGGGTCGCCATACCCTTTCCACTTCCTGGTCGGGAACCTCT	Cassette6_3
GGGGCGCAAGGAGCCTTCACTTATCAAAACTCACTGGGGAATGGCCGGCGCTTTCGTACCTGGTGCAGTCATCTCCCCATGGGTCGCCATACCCTTTCCACTTCCTGGTCGGGAACCTCT	Cassette6_4
GGGGCGCAAGGAGCCTTCACTTATCAAAACTCACTGGGGAATGTCCGGCGCTTTCGTACCTGGTGCAGTCATCTCCCCATGGGTCGCCATACCCTTTCCACTTCCTGGTCGGGAACCTCT	Cassette6_4
GGGGCGCAAGGAGCCTTCACTTATCAAAACTCACTGGGGAAAATGCGGCGCTTTCGTACCTGGTGCAGTCATCTCCCCATGGGTCGCCATACCCTTTCCACTTCCTGGTCGGGAACCTCT	Cassette6_5
GGGGCGCAAGGAGCCTTCACTTATCAAAACTCACTGGGGAAAATTCGGCGCTTTCGTACCTGGTGCAGTCATCTCCCCATGGGTCGCCATACCCTTTCCACTTCCTGGTCGGGAACCTCT	Cassette6_5
GGGGCGCAAGGAGCCTTCACTTATCAAAACTCACTGGGGATTATCGGGCGCTTTCGTACCTGGTGCAGTCATCTCCCCATGGGTCGCCATACCCTTTCCACTTCCTGGTCGGGAACCTCT	Cassette6_6
GGGGCGCAAGGAGCCTTCACTTATCAAAACTCACTGGGGATTATCTGGCGCTTTCGTACCTGGTGCAGTCATCTCCCCATGGGTCGCCATACCCTTTCCACTTCCTGGTCGGGAACCTCT	Cassette6_6
GGGGCGCAAGGAGCCTTCACTTATCAAAACTCACTGGGGATTGCCTGGCGCTTTCGTACCTGGTGCAGTCATCTCCCCATGGGTCGCCATACCCTTTCCACTTCCTGGTCGGGAACCTCT	Cassette6_7
GGGGCGCAAGGAGCCTTCACTTATCAAAACTCACTGGGGATTGCCTTGCGCTTTCGTACCTGGTGCAGTCATCTCCCCATGGGTCGCCATACCCTTTCCACTTCCTGGTCGGGAACCTCT	Cassette6_7
GGGGCGCAAGGAGCCTTCACTTATCAAAACTCACTGGGGATAATGTGGCGCTTTCGTACCTGGTGCAGTCATCTCCCCATGGGTCGCCATACCCTTTCCACTTCCTGGTCGGGAACCTCT	Cassette6_8
GGGGCGCAAGGAGCCTTCACTTATCAAAACTCACTGGGGATAATGTGTCGCTTTCGTACCTGGTGCAGTCATCTCCCCATGGGTCGCCATACCCTTTCCACTTCCTGGTCGGGAACCTCT	Cassette6_8
GGGGCGCAAGGAGCCTTCACTTATCAAAACTCACTGGGGAAAGCGCGGGTATTTCGTACCTGGTGCAGTCATCTCCCCATGGGTCGCCATACCCTTTCCACTTCCTGGTCGGGAACCTCT	Cassette7_1
GGGGCGCAAGGAGCCTTCACTTATCAAAACTCACTGGGGAAAGCGCGGTTATTTCGTACCTGGTGCAGTCATCTCCCCATGGGTCGCCATACCCTTTCCACTTCCTGGTCGGGAACCTCT	Cassette7_1
GGGGCGCAAGGAGCCTTCACTTATCAAAACTCACTGGGGAAAGCGCGGTGCGTTCGTACCTGGTGCAGTCATCTCCCCATGGGTCGCCATACCCTTTCCACTTCCTGGTCGGGAACCTCT	Cassette7_2
GGGGCGCAAGGAGCCTTCACTTATCAAAACTCACTGGGGAAAGCGCGGTTCGTTCGTACCTGGTGCAGTCATCTCCCCATGGGTCGCCATACCCTTTCCACTTCCTGGTCGGGAACCTCT	Cassette7_2
GGGGCGCAAGGAGCCTTCACTTATCAAAACTCACTGGGGAAAGCGCGGTGGTGTCGTACCTGGTGCAGTCATCTCCCCATGGGTCGCCATACCCTTTCCACTTCCTGGTCGGGAACCTCT	Cassette7_3
GGGGCGCAAGGAGCCTTCACTTATCAAAACTCACTGGGGAAAGCGCGGTGTTGTCGTACCTGGTGCAGTCATCTCCCCATGGGTCGCCATACCCTTTCCACTTCCTGGTCGGGAACCTCT	Cassette7_3
GGGGCGCAAGGAGCCTTCACTTATCAAAACTCACTGGGGAAAGCGCGGCTCGGTCGTACCTGGTGCAGTCATCTCCCCATGGGTCGCCATACCCTTTCCACTTCCTGGTCGGGAACCTCT	Cassette7_4
GGGGCGCAAGGAGCCTTCACTTATCAAAACTCACTGGGGAAAGCGCGGCTCTGTCGTACCTGGTGCAGTCATCTCCCCATGGGTCGCCATACCCTTTCCACTTCCTGGTCGGGAACCTCT	Cassette7_4
GGGGCGCAAGGAGCCTTCACTTATCAAAACTCACTGGGGAAAGCGCGGCGAGGTCGTACCTGGTGCAGTCATCTCCCCATGGGTCGCCATACCCTTTCCACTTCCTGGTCGGGAACCTCT	Cassette7_5
GGGGCGCAAGGAGCCTTCACTTATCAAAACTCACTGGGGAAAGCGCGGCGAGTTCGTACCTGGTGCAGTCATCTCCCCATGGGTCGCCATACCCTTTCCACTTCCTGGTCGGGAACCTCT	Cassette7_5
GGGGCGCAAGGAGCCTTCACTTATCAAAACTCACTGGGGAAAGCGCGGTTAGGGCGTACCTGGTGCAGTCATCTCCCCATGGGTCGCCATACCCTTTCCACTTCCTGGTCGGGAACCTCT	Cassette7_6
GGGGCGCAAGGAGCCTTCACTTATCAAAACTCACTGGGGAAAGCGCGGTTAGGTCGTACCTGGTGCAGTCATCTCCCCATGGGTCGCCATACCCTTTCCACTTCCTGGTCGGGAACCTCT	Cassette7_6
GGGGCGCAAGGAGCCTTCACTTATCAAAACTCACTGGGGAAAGCGCGGTTCTTCGGTACCTGGTGCAGTCATCTCCCCATGGGTCGCCATACCCTTTCCACTTCCTGGTCGGGAACCTCT	Cassette7_7
GGGGCGCAAGGAGCCTTCACTTATCAAAACTCACTGGGGAAAGCGCGGTTCTTCTGTACCTGGTGCAGTCATCTCCCCATGGGTCGCCATACCCTTTCCACTTCCTGGTCGGGAACCTCT	Cassette7_7
GGGGCGCAAGGAGCCTTCACTTATCAAAACTCACTGGGGAAAGCGCGGTGCGGCCGTACCTGGTGCAGTCATCTCCCCATGGGTCGCCATACCCTTTCCACTTCCTGGTCGGGAACCTCT	Cassette7_8
GGGGCGCAAGGAGCCTTCACTTATCAAAACTCACTGGGGAAAGCGCGGTGCGGCCTTACCTGGTGCAGTCATCTCCCCATGGGTCGCCATACCCTTTCCACTTCCTGGTCGGGAACCTCT	Cassette7_8
GGGGCGCAAGGAGCCTTCACTTATCAAAACTCACTGGGGAAAGCGCGGCGCTTTCGGCACTGGTGCAGTCATCTCCCCATGGGTCGCCATACCCTTTCCACTTCCTGGTCGGGAACCTCT	Cassette8_1
GGGGCGCAAGGAGCCTTCACTTATCAAAACTCACTGGGGAAAGCGCGGCGCTTTCGTCACTGGTGCAGTCATCTCCCCATGGGTCGCCATACCCTTTCCACTTCCTGGTCGGGAACCTCT	Cassette8_1
GGGGCGCAAGGAGCCTTCACTTATCAAAACTCACTGGGGAAAGCGCGGCGCTTTCGCGCTTGGTGCAGTCATCTCCCCATGGGTCGCCATACCCTTTCCACTTCCTGGTCGGGAACCTCT	Cassette8_2
GGGGCGCAAGGAGCCTTCACTTATCAAAACTCACTGGGGAAAGCGCGGCGCTTTCGCTCTTGGTGCAGTCATCTCCCCATGGGTCGCCATACCCTTTCCACTTCCTGGTCGGGAACCTCT	Cassette8_2
GGGGCGCAAGGAGCCTTCACTTATCAAAACTCACTGGGGAAAGCGCGGCGCTTTCGCAGCAGGTGCAGTCATCTCCCCATGGGTCGCCATACCCTTTCCACTTCCTGGTCGGGAACCTCT	Cassette8_3
GGGGCGCAAGGAGCCTTCACTTATCAAAACTCACTGGGGAAAGCGCGGCGCTTTCGCATCAGGTGCAGTCATCTCCCCATGGGTCGCCATACCCTTTCCACTTCCTGGTCGGGAACCTCT	Cassette8_3
GGGGCGCAAGGAGCCTTCACTTATCAAAACTCACTGGGGAAAGCGCGGCGCTTTCGTCCGAGGTGCAGTCATCTCCCCATGGGTCGCCATACCCTTTCCACTTCCTGGTCGGGAACCTCT	Cassette8_4
GGGGCGCAAGGAGCCTTCACTTATCAAAACTCACTGGGGAAAGCGCGGCGCTTTCGTCCTAGGTGCAGTCATCTCCCCATGGGTCGCCATACCCTTTCCACTTCCTGGTCGGGAACCTCT	Cassette8_4
GGGGCGCAAGGAGCCTTCACTTATCAAAACTCACTGGGGAAAGCGCGGCGCTTTCGTAATGGGTGCAGTCATCTCCCCATGGGTCGCCATACCCTTTCCACTTCCTGGTCGGGAACCTCT	Cassette8_5
GGGGCGCAAGGAGCCTTCACTTATCAAAACTCACTGGGGAAAGCGCGGCGCTTTCGTAATTGGTGCAGTCATCTCCCCATGGGTCGCCATACCCTTTCCACTTCCTGGTCGGGAACCTCT	Cassette8_5
GGGGCGCAAGGAGCCTTCACTTATCAAAACTCACTGGGGAAAGCGCGGCGCTTTCGCCATAGGTGCAGTCATCTCCCCATGGGTCGCCATACCCTTTCCACTTCCTGGTCGGGAACCTCT	Cassette8_6
GGGGCGCAAGGAGCCTTCACTTATCAAAACTCACTGGGGAAAGCGCGGCGCTTTCGCCATATGTGCAGTCATCTCCCCATGGGTCGCCATACCCTTTCCACTTCCTGGTCGGGAACCTCT	Cassette8_6
GGGGCGCAAGGAGCCTTCACTTATCAAAACTCACTGGGGAAAGCGCGGCGCTTTCGCCCCAAGTGCAGTCATCTCCCCATGGGTCGCCATACCCTTTCCACTTCCTGGTCGGGAACCTCT	Cassette8_7
GGGGCGCAAGGAGCCTTCACTTATCAAAACTCACTGGGGAAAGCGCGGCGCTTTCGCCCCAATTGCAGTCATCTCCCCATGGGTCGCCATACCCTTTCCACTTCCTGGTCGGGAACCTCT	Cassette8_7
GGGGCGCAAGGAGCCTTCACTTATCAAAACTCACTGGGGAAAGCGCGGCGCTTTCGCAATTAGGGCAGTCATCTCCCCATGGGTCGCCATACCCTTTCCACTTCCTGGTCGGGAACCTCT	Cassette8_8
GGGGCGCAAGGAGCCTTCACTTATCAAAACTCACTGGGGAAAGCGCGGCGCTTTCGCAATTAGTGCAGTCATCTCCCCATGGGTCGCCATACCCTTTCCACTTCCTGGTCGGGAACCTCT	Cassette8_8
GGGGCGCAAGGAGCCTTCACTTATCAAAACTCACTGGGGAAAGCGCGGCGCTTTCGTACCTGGTGTGGTCATCTCCCCATGGGTCGCCATACCCTTTCCACTTCCTGGTCGGGAACCTCT	Cassette9_1
GGGGCGCAAGGAGCCTTCACTTATCAAAACTCACTGGGGAAAGCGCGGCGCTTTCGTACCTGGTTTGGTCATCTCCCCATGGGTCGCCATACCCTTTCCACTTCCTGGTCGGGAACCTCT	Cassette9_1
GGGGCGCAAGGAGCCTTCACTTATCAAAACTCACTGGGGAAAGCGCGGCGCTTTCGTACCTGGTAGAATCATCTCCCCATGGGTCGCCATACCCTTTCCACTTCCTGGTCGGGAACCTCT	Cassette9_2
GGGGCGCAAGGAGCCTTCACTTATCAAAACTCACTGGGGAAAGCGCGGCGCTTTCGTACCTGGTATAATCATCTCCCCATGGGTCGCCATACCCTTTCCACTTCCTGGTCGGGAACCTCT	Cassette9_2
GGGGCGCAAGGAGCCTTCACTTATCAAAACTCACTGGGGAAAGCGCGGCGCTTTCGTACCTGGTACGGCCATCTCCCCATGGGTCGCCATACCCTTTCCACTTCCTGGTCGGGAACCTCT	Cassette9_3
GGGGCGCAAGGAGCCTTCACTTATCAAAACTCACTGGGGAAAGCGCGGCGCTTTCGTACCTGGTACTGCCATCTCCCCATGGGTCGCCATACCCTTTCCACTTCCTGGTCGGGAACCTCT	Cassette9_3
GGGGCGCAAGGAGCCTTCACTTATCAAAACTCACTGGGGAAAGCGCGGCGCTTTCGTACCTGGTGTAGCCATCTCCCCATGGGTCGCCATACCCTTTCCACTTCCTGGTCGGGAACCTCT	Cassette9_4
GGGGCGCAAGGAGCCTTCACTTATCAAAACTCACTGGGGAAAGCGCGGCGCTTTCGTACCTGGTGTATCCATCTCCCCATGGGTCGCCATACCCTTTCCACTTCCTGGTCGGGAACCTCT	Cassette9_4
GGGGCGCAAGGAGCCTTCACTTATCAAAACTCACTGGGGAAAGCGCGGCGCTTTCGTACCTGGTGCGAGCATCTCCCCATGGGTCGCCATACCCTTTCCACTTCCTGGTCGGGAACCTCT	Cassette9_5
GGGGCGCAAGGAGCCTTCACTTATCAAAACTCACTGGGGAAAGCGCGGCGCTTTCGTACCTGGTGCGATCATCTCCCCATGGGTCGCCATACCCTTTCCACTTCCTGGTCGGGAACCTCT	Cassette9_5
GGGGCGCAAGGAGCCTTCACTTATCAAAACTCACTGGGGAAAGCGCGGCGCTTTCGTACCTGGTATGACGATCTCCCCATGGGTCGCCATACCCTTTCCACTTCCTGGTCGGGAACCTCT	Cassette9_6
GGGGCGCAAGGAGCCTTCACTTATCAAAACTCACTGGGGAAAGCGCGGCGCTTTCGTACCTGGTATGACTATCTCCCCATGGGTCGCCATACCCTTTCCACTTCCTGGTCGGGAACCTCT	Cassette9_6
GGGGCGCAAGGAGCCTTCACTTATCAAAACTCACTGGGGAAAGCGCGGCGCTTTCGTACCTGGTATAGCAGTCTCCCCATGGGTCGCCATACCCTTTCCACTTCCTGGTCGGGAACCTCT	Cassette9_7
GGGGCGCAAGGAGCCTTCACTTATCAAAACTCACTGGGGAAAGCGCGGCGCTTTCGTACCTGGTATAGCATTCTCCCCATGGGTCGCCATACCCTTTCCACTTCCTGGTCGGGAACCTCT	Cassette9_7
GGGGCGCAAGGAGCCTTCACTTATCAAAACTCACTGGGGAAAGCGCGGCGCTTTCGTACCTGGTACGATAAGCTCCCCATGGGTCGCCATACCCTTTCCACTTCCTGGTCGGGAACCTCT	Cassette9_8
GGGGCGCAAGGAGCCTTCACTTATCAAAACTCACTGGGGAAAGCGCGGCGCTTTCGTACCTGGTACGATAATCTCCCCATGGGTCGCCATACCCTTTCCACTTCCTGGTCGGGAACCTCT	Cassette9_8
GGGGCGCAAGGAGCCTTCACTTATCAAAACTCACTGGGGAAAGCGCGGCGCTTTCGTACCTGGTGCAGTCATGCTCCCATGGGTCGCCATACCCTTTCCACTTCCTGGTCGGGAACCTCT	Cassette10_1
GGGGCGCAAGGAGCCTTCACTTATCAAAACTCACTGGGGAAAGCGCGGCGCTTTCGTACCTGGTGCAGTCATTCTCCCATGGGTCGCCATACCCTTTCCACTTCCTGGTCGGGAACCTCT	Cassette10_1
GGGGCGCAAGGAGCCTTCACTTATCAAAACTCACTGGGGAAAGCGCGGCGCTTTCGTACCTGGTGCAGTCATTGCTCCATGGGTCGCCATACCCTTTCCACTTCCTGGTCGGGAACCTCT	Cassette10_2
GGGGCGCAAGGAGCCTTCACTTATCAAAACTCACTGGGGAAAGCGCGGCGCTTTCGTACCTGGTGCAGTCATTTCTCCATGGGTCGCCATACCCTTTCCACTTCCTGGTCGGGAACCTCT	Cassette10_2
GGGGCGCAAGGAGCCTTCACTTATCAAAACTCACTGGGGAAAGCGCGGCGCTTTCGTACCTGGTGCAGTCATTTGCTCATGGGTCGCCATACCCTTTCCACTTCCTGGTCGGGAACCTCT	Cassette10_3
GGGGCGCAAGGAGCCTTCACTTATCAAAACTCACTGGGGAAAGCGCGGCGCTTTCGTACCTGGTGCAGTCATTTTCTCATGGGTCGCCATACCCTTTCCACTTCCTGGTCGGGAACCTCT	Cassette10_3
GGGGCGCAAGGAGCCTTCACTTATCAAAACTCACTGGGGAAAGCGCGGCGCTTTCGTACCTGGTGCAGTCATCCCGTCATGGGTCGCCATACCCTTTCCACTTCCTGGTCGGGAACCTCT	Cassette10_4
GGGGCGCAAGGAGCCTTCACTTATCAAAACTCACTGGGGAAAGCGCGGCGCTTTCGTACCTGGTGCAGTCATCCCTTCATGGGTCGCCATACCCTTTCCACTTCCTGGTCGGGAACCTCT	Cassette10_4
GGGGCGCAAGGAGCCTTCACTTATCAAAACTCACTGGGGAAAGCGCGGCGCTTTCGTACCTGGTGCAGTCATCTTTGCATGGGTCGCCATACCCTTTCCACTTCCTGGTCGGGAACCTCT	Cassette10_5
GGGGCGCAAGGAGCCTTCACTTATCAAAACTCACTGGGGAAAGCGCGGCGCTTTCGTACCTGGTGCAGTCATCTTTTCATGGGTCGCCATACCCTTTCCACTTCCTGGTCGGGAACCTCT	Cassette10_5
GGGGCGCAAGGAGCCTTCACTTATCAAAACTCACTGGGGAAAGCGCGGCGCTTTCGTACCTGGTGCAGTCATTCTTTGATGGGTCGCCATACCCTTTCCACTTCCTGGTCGGGAACCTCT	Cassette10_6
GGGGCGCAAGGAGCCTTCACTTATCAAAACTCACTGGGGAAAGCGCGGCGCTTTCGTACCTGGTGCAGTCATTCTTTTATGGGTCGCCATACCCTTTCCACTTCCTGGTCGGGAACCTCT	Cassette10_6
GGGGCGCAAGGAGCCTTCACTTATCAAAACTCACTGGGGAAAGCGCGGCGCTTTCGTACCTGGTGCAGTCATTCCCCAGTGGGTCGCCATACCCTTTCCACTTCCTGGTCGGGAACCTCT	Cassette10_7
GGGGCGCAAGGAGCCTTCACTTATCAAAACTCACTGGGGAAAGCGCGGCGCTTTCGTACCTGGTGCAGTCATTCCCCATTGGGTCGCCATACCCTTTCCACTTCCTGGTCGGGAACCTCT	Cassette10_7
GGGGCGCAAGGAGCCTTCACTTATCAAAACTCACTGGGGAAAGCGCGGCGCTTTCGTACCTGGTGCAGTCATTTTCCAAGGGGTCGCCATACCCTTTCCACTTCCTGGTCGGGAACCTCT	Cassette10_8
GGGGCGCAAGGAGCCTTCACTTATCAAAACTCACTGGGGAAAGCGCGGCGCTTTCGTACCTGGTGCAGTCATTTTCCAATGGGTCGCCATACCCTTTCCACTTCCTGGTCGGGAACCTCT	Cassette10_8
GGGGCGCAAGGAGCCTTCACTTATCAAAACTCACTGGGGAAAGCGCGGCGCTTTCGTACCTGGTGCAGTCATCTCCCCATGACTCGCCATACCCTTTCCACTTCCTGGTCGGGAACCTCT	Cassette11_1
GGGGCGCAAGGAGCCTTCACTTATCAAAACTCACTGGGGAAAGCGCGGCGCTTTCGTACCTGGTGCAGTCATCTCCCCATTACTCGCCATACCCTTTCCACTTCCTGGTCGGGAACCTCT	Cassette11_1
GGGGCGCAAGGAGCCTTCACTTATCAAAACTCACTGGGGAAAGCGCGGCGCTTTCGTACCTGGTGCAGTCATCTCCCCATGGCCTGCCATACCCTTTCCACTTCCTGGTCGGGAACCTCT	Cassette11_2
GGGGCGCAAGGAGCCTTCACTTATCAAAACTCACTGGGGAAAGCGCGGCGCTTTCGTACCTGGTGCAGTCATCTCCCCATGTCCTGCCATACCCTTTCCACTTCCTGGTCGGGAACCTCT	Cassette11_2
GGGGCGCAAGGAGCCTTCACTTATCAAAACTCACTGGGGAAAGCGCGGCGCTTTCGTACCTGGTGCAGTCATCTCCCCATGGGCCCCCATACCCTTTCCACTTCCTGGTCGGGAACCTCT	Cassette11_3
GGGGCGCAAGGAGCCTTCACTTATCAAAACTCACTGGGGAAAGCGCGGCGCTTTCGTACCTGGTGCAGTCATCTCCCCATGGTCCCCCATACCCTTTCCACTTCCTGGTCGGGAACCTCT	Cassette11_3
GGGGCGCAAGGAGCCTTCACTTATCAAAACTCACTGGGGAAAGCGCGGCGCTTTCGTACCTGGTGCAGTCATCTCCCCATGAGGTCCCATACCCTTTCCACTTCCTGGTCGGGAACCTCT	Cassette11_4
GGGGCGCAAGGAGCCTTCACTTATCAAAACTCACTGGGGAAAGCGCGGCGCTTTCGTACCTGGTGCAGTCATCTCCCCATGAGTTCCCATACCCTTTCCACTTCCTGGTCGGGAACCTCT	Cassette11_4
GGGGCGCAAGGAGCCTTCACTTATCAAAACTCACTGGGGAAAGCGCGGCGCTTTCGTACCTGGTGCAGTCATCTCCCCATGGCTGCACATACCCTTTCCACTTCCTGGTCGGGAACCTCT	Cassette11_5
GGGGCGCAAGGAGCCTTCACTTATCAAAACTCACTGGGGAAAGCGCGGCGCTTTCGTACCTGGTGCAGTCATCTCCCCATGGCTTCACATACCCTTTCCACTTCCTGGTCGGGAACCTCT	Cassette11_5
GGGGCGCAAGGAGCCTTCACTTATCAAAACTCACTGGGGAAAGCGCGGCGCTTTCGTACCTGGTGCAGTCATCTCCCCATGGGCTGACATACCCTTTCCACTTCCTGGTCGGGAACCTCT	Cassette11_6
GGGGCGCAAGGAGCCTTCACTTATCAAAACTCACTGGGGAAAGCGCGGCGCTTTCGTACCTGGTGCAGTCATCTCCCCATGGGCTTACATACCCTTTCCACTTCCTGGTCGGGAACCTCT	Cassette11_6
GGGGCGCAAGGAGCCTTCACTTATCAAAACTCACTGGGGAAAGCGCGGCGCTTTCGTACCTGGTGCAGTCATCTCCCCATGAGCCGGCATACCCTTTCCACTTCCTGGTCGGGAACCTCT	Cassette11_7
GGGGCGCAAGGAGCCTTCACTTATCAAAACTCACTGGGGAAAGCGCGGCGCTTTCGTACCTGGTGCAGTCATCTCCCCATGAGCCGTCATACCCTTTCCACTTCCTGGTCGGGAACCTCT	Cassette11_7
GGGGCGCAAGGAGCCTTCACTTATCAAAACTCACTGGGGAAAGCGCGGCGCTTTCGTACCTGGTGCAGTCATCTCCCCATGGCCCGAGATACCCTTTCCACTTCCTGGTCGGGAACCTCT	Cassette11_8
GGGGCGCAAGGAGCCTTCACTTATCAAAACTCACTGGGGAAAGCGCGGCGCTTTCGTACCTGGTGCAGTCATCTCCCCATGGCCCGATATACCCTTTCCACTTCCTGGTCGGGAACCTCT	Cassette11_8
GGGGCGCAAGGAGCCTTCACTTATCAAAACTCACTGGGGAAAGCGCGGCGCTTTCGTACCTGGTGCAGTCATCTCCCCATGGGTCGCCGCCCCCTTTCCACTTCCTGGTCGGGAACCTCT	Cassette12_1
GGGGCGCAAGGAGCCTTCACTTATCAAAACTCACTGGGGAAAGCGCGGCGCTTTCGTACCTGGTGCAGTCATCTCCCCATGGGTCGCCTCCCCCTTTCCACTTCCTGGTCGGGAACCTCT	Cassette12_1
GGGGCGCAAGGAGCCTTCACTTATCAAAACTCACTGGGGAAAGCGCGGCGCTTTCGTACCTGGTGCAGTCATCTCCCCATGGGTCGCCGGAACCTTTCCACTTCCTGGTCGGGAACCTCT	Cassette12_2
GGGGCGCAAGGAGCCTTCACTTATCAAAACTCACTGGGGAAAGCGCGGCGCTTTCGTACCTGGTGCAGTCATCTCCCCATGGGTCGCCGTAACCTTTCCACTTCCTGGTCGGGAACCTCT	Cassette12_2
GGGGCGCAAGGAGCCTTCACTTATCAAAACTCACTGGGGAAAGCGCGGCGCTTTCGTACCTGGTGCAGTCATCTCCCCATGGGTCGCCGTGCACTTTCCACTTCCTGGTCGGGAACCTCT	Cassette12_3
GGGGCGCAAGGAGCCTTCACTTATCAAAACTCACTGGGGAAAGCGCGGCGCTTTCGTACCTGGTGCAGTCATCTCCCCATGGGTCGCCGTTCACTTTCCACTTCCTGGTCGGGAACCTCT	Cassette12_3
GGGGCGCAAGGAGCCTTCACTTATCAAAACTCACTGGGGAAAGCGCGGCGCTTTCGTACCTGGTGCAGTCATCTCCCCATGGGTCGCCACAGACTTTCCACTTCCTGGTCGGGAACCTCT	Cassette12_4
GGGGCGCAAGGAGCCTTCACTTATCAAAACTCACTGGGGAAAGCGCGGCGCTTTCGTACCTGGTGCAGTCATCTCCCCATGGGTCGCCACATACTTTCCACTTCCTGGTCGGGAACCTCT	Cassette12_4
GGGGCGCAAGGAGCCTTCACTTATCAAAACTCACTGGGGAAAGCGCGGCGCTTTCGTACCTGGTGCAGTCATCTCCCCATGGGTCGCCATCAGCTTTCCACTTCCTGGTCGGGAACCTCT	Cassette12_5
GGGGCGCAAGGAGCCTTCACTTATCAAAACTCACTGGGGAAAGCGCGGCGCTTTCGTACCTGGTGCAGTCATCTCCCCATGGGTCGCCATCATCTTTCCACTTCCTGGTCGGGAACCTCT	Cassette12_5
GGGGCGCAAGGAGCCTTCACTTATCAAAACTCACTGGGGAAAGCGCGGCGCTTTCGTACCTGGTGCAGTCATCTCCCCATGGGTCGCCGCCAAGTTTCCACTTCCTGGTCGGGAACCTCT	Cassette12_6
GGGGCGCAAGGAGCCTTCACTTATCAAAACTCACTGGGGAAAGCGCGGCGCTTTCGTACCTGGTGCAGTCATCTCCCCATGGGTCGCCGCCAATTTTCCACTTCCTGGTCGGGAACCTCT	Cassette12_6
GGGGCGCAAGGAGCCTTCACTTATCAAAACTCACTGGGGAAAGCGCGGCGCTTTCGTACCTGGTGCAGTCATCTCCCCATGGGTCGCCGTCACTGTTCCACTTCCTGGTCGGGAACCTCT	Cassette12_7
GGGGCGCAAGGAGCCTTCACTTATCAAAACTCACTGGGGAAAGCGCGGCGCTTTCGTACCTGGTGCAGTCATCTCCCCATGGGTCGCCGTCACTTTTCCACTTCCTGGTCGGGAACCTCT	Cassette12_7
GGGGCGCAAGGAGCCTTCACTTATCAAAACTCACTGGGGAAAGCGCGGCGCTTTCGTACCTGGTGCAGTCATCTCCCCATGGGTCGCCGTAAATTGTCCACTTCCTGGTCGGGAACCTCT	Cassette12_8
GGGGCGCAAGGAGCCTTCACTTATCAAAACTCACTGGGGAAAGCGCGGCGCTTTCGTACCTGGTGCAGTCATCTCCCCATGGGTCGCCGTAAATTTTCCACTTCCTGGTCGGGAACCTCT	Cassette12_8
GGGGCGCAAGGAGCCTTCACTTATCAAAACTCACTGGGGAAAGCGCGGCGCTTTCGTACCTGGTGCAGTCATCTCCCCATGGGTCGCCATACCCTTGATACTTCCTGGTCGGGAACCTCT	Cassette13_1
GGGGCGCAAGGAGCCTTCACTTATCAAAACTCACTGGGGAAAGCGCGGCGCTTTCGTACCTGGTGCAGTCATCTCCCCATGGGTCGCCATACCCTTTATACTTCCTGGTCGGGAACCTCT	Cassette13_1
GGGGCGCAAGGAGCCTTCACTTATCAAAACTCACTGGGGAAAGCGCGGCGCTTTCGTACCTGGTGCAGTCATCTCCCCATGGGTCGCCATACCCTTAGCTCTTCCTGGTCGGGAACCTCT	Cassette13_2
GGGGCGCAAGGAGCCTTCACTTATCAAAACTCACTGGGGAAAGCGCGGCGCTTTCGTACCTGGTGCAGTCATCTCCCCATGGGTCGCCATACCCTTATCTCTTCCTGGTCGGGAACCTCT	Cassette13_2
GGGGCGCAAGGAGCCTTCACTTATCAAAACTCACTGGGGAAAGCGCGGCGCTTTCGTACCTGGTGCAGTCATCTCCCCATGGGTCGCCATACCCTTACGATTTCCTGGTCGGGAACCTCT	Cassette13_3
GGGGCGCAAGGAGCCTTCACTTATCAAAACTCACTGGGGAAAGCGCGGCGCTTTCGTACCTGGTGCAGTCATCTCCCCATGGGTCGCCATACCCTTACTATTTCCTGGTCGGGAACCTCT	Cassette13_3
GGGGCGCAAGGAGCCTTCACTTATCAAAACTCACTGGGGAAAGCGCGGCGCTTTCGTACCTGGTGCAGTCATCTCCCCATGGGTCGCCATACCCTTTACGTTTCCTGGTCGGGAACCTCT	Cassette13_4
GGGGCGCAAGGAGCCTTCACTTATCAAAACTCACTGGGGAAAGCGCGGCGCTTTCGTACCTGGTGCAGTCATCTCCCCATGGGTCGCCATACCCTTTACTTTTCCTGGTCGGGAACCTCT	Cassette13_4
GGGGCGCAAGGAGCCTTCACTTATCAAAACTCACTGGGGAAAGCGCGGCGCTTTCGTACCTGGTGCAGTCATCTCCCCATGGGTCGCCATACCCTTTCTTGTTCCTGGTCGGGAACCTCT	Cassette13_5
GGGGCGCAAGGAGCCTTCACTTATCAAAACTCACTGGGGAAAGCGCGGCGCTTTCGTACCTGGTGCAGTCATCTCCCCATGGGTCGCCATACCCTTTCTTTTTCCTGGTCGGGAACCTCT	Cassette13_5
GGGGCGCAAGGAGCCTTCACTTATCAAAACTCACTGGGGAAAGCGCGGCGCTTTCGTACCTGGTGCAGTCATCTCCCCATGGGTCGCCATACCCTTAATTTGTCCTGGTCGGGAACCTCT	Cassette13_6
GGGGCGCAAGGAGCCTTCACTTATCAAAACTCACTGGGGAAAGCGCGGCGCTTTCGTACCTGGTGCAGTCATCTCCCCATGGGTCGCCATACCCTTAATTTTTCCTGGTCGGGAACCTCT	Cassette13_6
GGGGCGCAAGGAGCCTTCACTTATCAAAACTCACTGGGGAAAGCGCGGCGCTTTCGTACCTGGTGCAGTCATCTCCCCATGGGTCGCCATACCCTTAACACCGCCTGGTCGGGAACCTCT	Cassette13_7
GGGGCGCAAGGAGCCTTCACTTATCAAAACTCACTGGGGAAAGCGCGGCGCTTTCGTACCTGGTGCAGTCATCTCCCCATGGGTCGCCATACCCTTAACACCTCCTGGTCGGGAACCTCT	Cassette13_7
GGGGCGCAAGGAGCCTTCACTTATCAAAACTCACTGGGGAAAGCGCGGCGCTTTCGTACCTGGTGCAGTCATCTCCCCATGGGTCGCCATACCCTTACTTCCTGCTGGTCGGGAACCTCT	Cassette13_8
GGGGCGCAAGGAGCCTTCACTTATCAAAACTCACTGGGGAAAGCGCGGCGCTTTCGTACCTGGTGCAGTCATCTCCCCATGGGTCGCCATACCCTTACTTCCTTCTGGTCGGGAACCTCT	Cassette13_8
GGGGCGCAAGGAGCCTTCACTTATCAAAACTCACTGGGGAAAGCGCGGCGCTTTCGTACCTGGTGCAGTCATCTCCCCATGGGTCGCCATACCCTTTCCACTTCGGTGTCGGGAACCTCT	Cassette14_1
GGGGCGCAAGGAGCCTTCACTTATCAAAACTCACTGGGGAAAGCGCGGCGCTTTCGTACCTGGTGCAGTCATCTCCCCATGGGTCGCCATACCCTTTCCACTTCTGTGTCGGGAACCTCT	Cassette14_1
GGGGCGCAAGGAGCCTTCACTTATCAAAACTCACTGGGGAAAGCGCGGCGCTTTCGTACCTGGTGCAGTCATCTCCCCATGGGTCGCCATACCCTTTCCACTTCTGTGCCGGGAACCTCT	Cassette14_2
GGGGCGCAAGGAGCCTTCACTTATCAAAACTCACTGGGGAAAGCGCGGCGCTTTCGTACCTGGTGCAGTCATCTCCCCATGGGTCGCCATACCCTTTCCACTTCTTTGCCGGGAACCTCT	Cassette14_2
GGGGCGCAAGGAGCCTTCACTTATCAAAACTCACTGGGGAAAGCGCGGCGCTTTCGTACCTGGTGCAGTCATCTCCCCATGGGTCGCCATACCCTTTCCACTTCCGGGCCGGGAACCTCT	Cassette14_3
GGGGCGCAAGGAGCCTTCACTTATCAAAACTCACTGGGGAAAGCGCGGCGCTTTCGTACCTGGTGCAGTCATCTCCCCATGGGTCGCCATACCCTTTCCACTTCCGTGCCGGGAACCTCT	Cassette14_3
GGGGCGCAAGGAGCCTTCACTTATCAAAACTCACTGGGGAAAGCGCGGCGCTTTCGTACCTGGTGCAGTCATCTCCCCATGGGTCGCCATACCCTTTCCACTTCTGGGTCGGGAACCTCT	Cassette14_4
GGGGCGCAAGGAGCCTTCACTTATCAAAACTCACTGGGGAAAGCGCGGCGCTTTCGTACCTGGTGCAGTCATCTCCCCATGGGTCGCCATACCCTTTCCACTTCTGGTTCGGGAACCTCT	Cassette14_4
GGGGCGCAAGGAGCCTTCACTTATCAAAACTCACTGGGGAAAGCGCGGCGCTTTCGTACCTGGTGCAGTCATCTCCCCATGGGTCGCCATACCCTTTCCACTTCTTTGGAGGGAACCTCT	Cassette14_5
GGGGCGCAAGGAGCCTTCACTTATCAAAACTCACTGGGGAAAGCGCGGCGCTTTCGTACCTGGTGCAGTCATCTCCCCATGGGTCGCCATACCCTTTCCACTTCTTTGTAGGGAACCTCT	Cassette14_5
GGGGCGCAAGGAGCCTTCACTTATCAAAACTCACTGGGGAAAGCGCGGCGCTTTCGTACCTGGTGCAGTCATCTCCCCATGGGTCGCCATACCCTTTCCACTTCTTGGCGGGGAACCTCT	Cassette14_6
GGGGCGCAAGGAGCCTTCACTTATCAAAACTCACTGGGGAAAGCGCGGCGCTTTCGTACCTGGTGCAGTCATCTCCCCATGGGTCGCCATACCCTTTCCACTTCTTGGCTGGGAACCTCT	Cassette14_6
GGGGCGCAAGGAGCCTTCACTTATCAAAACTCACTGGGGAAAGCGCGGCGCTTTCGTACCTGGTGCAGTCATCTCCCCATGGGTCGCCATACCCTTTCCACTTCTTTGTCGGGAACCTCT	Cassette14_7
GGGGCGCAAGGAGCCTTCACTTATCAAAACTCACTGGGGAAAGCGCGGCGCTTTCGTACCTGGTGCAGTCATCTCCCCATGGGTCGCCATACCCTTTCCACTTCTTTGTCTGGAACCTCT	Cassette14_7
GGGGCGCAAGGAGCCTTCACTTATCAAAACTCACTGGGGAAAGCGCGGCGCTTTCGTACCTGGTGCAGTCATCTCCCCATGGGTCGCCATACCCTTTCCACTTCTGGGCCGGGAACCTCT	Cassette14_8
GGGGCGCAAGGAGCCTTCACTTATCAAAACTCACTGGGGAAAGCGCGGCGCTTTCGTACCTGGTGCAGTCATCTCCCCATGGGTCGCCATACCCTTTCCACTTCTGGGCCGTGAACCTCT	Cassette14_8
GGGGCGCAAGGAGCCTTCACTTATCAAAACTCACTGGGGAAAGCGCGGCGCTTTCGTACCTGGTGCAGTCATCTCCCCATGGGTCGCCATACCCTTTCCACTTCCTGGTCGGGTCCCTCT	Cassette15_1
GGGGCGCAAGGAGCCTTCACTTATCAAAACTCACTGGGGAAAGCGCGGCGCTTTCGTACCTGGTGCAGTCATCTCCCCATGGGTCGCCATACCCTTTCCACTTCCTGGTCGGTTCCCTCT	Cassette15_1
GGGGCGCAAGGAGCCTTCACTTATCAAAACTCACTGGGGAAAGCGCGGCGCTTTCGTACCTGGTGCAGTCATCTCCCCATGGGTCGCCATACCCTTTCCACTTCCTGGTCGGAGAACTCT	Cassette15_2
GGGGCGCAAGGAGCCTTCACTTATCAAAACTCACTGGGGAAAGCGCGGCGCTTTCGTACCTGGTGCAGTCATCTCCCCATGGGTCGCCATACCCTTTCCACTTCCTGGTCGGATAACTCT	Cassette15_2
GGGGCGCAAGGAGCCTTCACTTATCAAAACTCACTGGGGAAAGCGCGGCGCTTTCGTACCTGGTGCAGTCATCTCCCCATGGGTCGCCATACCCTTTCCACTTCCTGGTCGGAAGCATCT	Cassette15_3
GGGGCGCAAGGAGCCTTCACTTATCAAAACTCACTGGGGAAAGCGCGGCGCTTTCGTACCTGGTGCAGTCATCTCCCCATGGGTCGCCATACCCTTTCCACTTCCTGGTCGGAATCATCT	Cassette15_3
GGGGCGCAAGGAGCCTTCACTTATCAAAACTCACTGGGGAAAGCGCGGCGCTTTCGTACCTGGTGCAGTCATCTCCCCATGGGTCGCCATACCCTTTCCACTTCCTGGTCGGGTAGATCT	Cassette15_4
GGGGCGCAAGGAGCCTTCACTTATCAAAACTCACTGGGGAAAGCGCGGCGCTTTCGTACCTGGTGCAGTCATCTCCCCATGGGTCGCCATACCCTTTCCACTTCCTGGTCGGGTATATCT	Cassette15_4
GGGGCGCAAGGAGCCTTCACTTATCAAAACTCACTGGGGAAAGCGCGGCGCTTTCGTACCTGGTGCAGTCATCTCCCCATGGGTCGCCATACCCTTTCCACTTCCTGGTCGGGACAGTCT	Cassette15_5
GGGGCGCAAGGAGCCTTCACTTATCAAAACTCACTGGGGAAAGCGCGGCGCTTTCGTACCTGGTGCAGTCATCTCCCCATGGGTCGCCATACCCTTTCCACTTCCTGGTCGGGACATTCT	Cassette15_5
GGGGCGCAAGGAGCCTTCACTTATCAAAACTCACTGGGGAAAGCGCGGCGCTTTCGTACCTGGTGCAGTCATCTCCCCATGGGTCGCCATACCCTTTCCACTTCCTGGTCGGATCAAGCT	Cassette15_6
GGGGCGCAAGGAGCCTTCACTTATCAAAACTCACTGGGGAAAGCGCGGCGCTTTCGTACCTGGTGCAGTCATCTCCCCATGGGTCGCCATACCCTTTCCACTTCCTGGTCGGATCAATCT	Cassette15_6
GGGGCGCAAGGAGCCTTCACTTATCAAAACTCACTGGGGAAAGCGCGGCGCTTTCGTACCTGGTGCAGTCATCTCCCCATGGGTCGCCATACCCTTTCCACTTCCTGGTCGGATACACGT	Cassette15_7
GGGGCGCAAGGAGCCTTCACTTATCAAAACTCACTGGGGAAAGCGCGGCGCTTTCGTACCTGGTGCAGTCATCTCCCCATGGGTCGCCATACCCTTTCCACTTCCTGGTCGGATACACTT	Cassette15_7
GGGGCGCAAGGAGCCTTCACTTATCAAAACTCACTGGGGAAAGCGCGGCGCTTTCGTACCTGGTGCAGTCATCTCCCCATGGGTCGCCATACCCTTTCCACTTCCTGGTCGGAACCCCCG	Cassette15_8
GGGGCGCAAGGAGCCTTCACTTATCAAAACTCACTGGGGAAAGCGCGGCGCTTTCGTACCTGGTGCAGTCATCTCCCCATGGGTCGCCATACCCTTTCCACTTCCTGGTCGGAACCCCCT	Cassette15_8
GGGGCGCAAGGAGCCTTCACTTATCAAAACTCACTGGGGAAAGCGCGGCGCTTTCGTACCTGGTGCAGTCATCTCCCCATGGGTCGCCATACCCTTTCCACTTCCTGGTCGGGAACCTCT	WT
